PRINTFORMW 「ねえ、そこの貴方」	PRINTFORMW 「喂、那边的你」
PRINTFORMW 突然呼び止められると怪訝そうな目で見つめてくる女性がいた。	PRINTFORMW 突然被叫住、有个女人用惊讶的眼神看着我。
PRINTFORMW 程よい長さのブラウンの髪、白いシャツと黒のロングスカートの少女―――	PRINTFORMW 那是一个留着及肩棕发、穿着白色衬衫和黑色长裙的少女―――
PRINTFORMW 「さっきから気持ち悪い目でこっち見てるけど、何か用かしら？」	PRINTFORMW 「从刚才就开始用恶心的眼神看着我、有什么事吗？」
PRINTFORMW 「私は蓮子、宇佐見蓮子よ、一応大学生で専門はひも理論、と言っても通じるかな……」	PRINTFORMW 「我叫蓮子、宇佐見蓮子、姑且是弦理论专业的大学生、这样说你能明白吗……」
PRINTFORMW そう言いながら彼女は考え込むような姿勢で%CALLNAME:MASTER%の顔をマジマジと見つめてる。	PRINTFORMW 她一边说一边用沉思的姿势凝视着%CALLNAME:MASTER%的脸。
PRINTFORMW 「それにしても、貴方って女好き？ナンパ？まあいいけど」	PRINTFORMW 「话说回来、你是想要女人？还是搭讪？我倒是无所谓啦」
PRINTFORMW 「%CALLNAME:MASTER%って言うのね、覚えておくわ」	PRINTFORMW 「你叫%CALLNAME:MASTER%、我会记住的」
PRINTFORMW 「私ともう一人、メリー……マエリベリー・ハーンって言う子と秘封倶楽部って活動をしているから」	PRINTFORMW 「我和另一个人、名叫梅莉……瑪愛露貝莉・赫恩的孩子一起进行着秘封俱乐部的活动」
PRINTFORMW 「何かあれば協力しましょうね、お互いアウェーな土地なんだもの」	PRINTFORMW 「如果发生了什么事要互相帮助哦、毕竟我们对这片土地来说都是客人」
PRINTFORMW 「%CALLNAME:MASTER%、ちょっといいかな？」	PRINTFORMW 「%CALLNAME:MASTER%、可以稍微停一下吗？」
PRINTFORMW 振り向きざまに髪の毛を少しかき分けながら彼女は%CALLNAME:MASTER%の顔にそっと手を伸ばした。	PRINTFORMW 她转过身、一边拨弄着头发、一边轻轻地把手伸向了%CALLNAME:MASTER%的脸。
PRINTFORMW 「%CALLNAME:MASTER%の眼、いつだって気味が悪いわ」	PRINTFORMW 「%CALLNAME:MASTER%的眼睛、总是让我觉得不舒服」
PRINTFORMW そう言いながら彼女は%CALLNAME:MASTER%の唇にキスをした。	PRINTFORMW 这么说着、她亲吻了%CALLNAME:MASTER%的嘴唇。
PRINTFORMW 「んっ…でもキスは気持ちいいわね」	PRINTFORMW 「嗯…但是和你接吻倒是很舒服」
PRINTFORMW 彼女はそう言って後ろ手に手を回し少しかがむような姿勢でこちらの様子をうかがっている。	PRINTFORMW 她这样说着、把手背过身后、稍微弯下了腰观察着这边的反应。
PRINTFORMW 「どうだった？私のキス、初めてなんだよ？	PRINTFORMW 「怎么样？刚刚那是、我的初吻哦？」
PRINTFORMW 照れくさそうにはにかんだ彼女はそのまま踵を返して去って行った。	PRINTFORMW 害羞的她就这样转身走了。
PRINTFORMW 「そうそうこれ、メリーには内緒だからね！」	PRINTFORMW 「对了对了、这件事要对梅莉保密哦！」
PRINTFORMW 「%CALLNAME:MASTER%、少しだけ話があるんだけど」	PRINTFORMW 「%CALLNAME:MASTER%、我有些话想跟你说」
PRINTFORMW 蓮子はいつになく緊張した口調で話しかけてきた。	PRINTFORMW 蓮子用比任何时候都紧张的语气向我搭话。
PRINTFORMW 「私、%CALLNAME:MASTER%の事が好きなの」	PRINTFORMW 「我、喜欢%CALLNAME:MASTER%」
PRINTFORMW 「いつだって私のこと気にかけてくれるとこも他の人にも優しいとこも全部好き」	PRINTFORMW 「无论何时都关心我的方面也好、温柔对待他人的方面也好、全部都喜欢」
PRINTFORMW 「どんな時でも私は%CALLNAME:MASTER%の事を考えるようになっちゃった」	PRINTFORMW 「现在的我无论何时何地都在想着关于%CALLNAME:MASTER%的事情」
PRINTFORMW 「こんなにも人のことを考えるときが来るなんて思ってもみなかったわ！」	PRINTFORMW 「我从来没有想到会有一天我会如此思念着一个人！」
PRINTFORMW 「本当ならそれで我慢した方が良いのかもしれないけど、独り占めしたくなっちゃったの」	PRINTFORMW 「本来我觉得也许就这样忍耐就好了、但是现在我变得想要独占你了」
PRINTFORMW 「%CALLNAME:MASTER%、私の恋人になってくれませんか？」	PRINTFORMW 「%CALLNAME:MASTER%、你能成为我的恋人吗？」
PRINTFORMW 「%CALLNAME:MASTER%、私と恋人になるのはどうしてもダメ？」	PRINTFORMW 「%CALLNAME:MASTER%、就不能成为我的恋人吗？」
PRINTFORMW 蓮子は再び告白してきた。	PRINTFORMW 蓮子再次告白了。
PRINTFORMW 「私と%CALLNAME:MASTER%の運命の赤い糸は誰にも切れないのよ？」	PRINTFORMW 「我和%CALLNAME:MASTER%之间的命运的红线无论是谁都无法剪断的哟？」
PRINTFORMW 「ありがと、%CALLNAME:MASTER%」	PRINTFORMW 「谢谢你、%CALLNAME:MASTER%」
PRINTFORMW 「生けとし生ける限り私達の運命は結ばれる縁だったのよ」	PRINTFORMW 「只要我们还活在世上、我们的命运就是注定相连的缘分」
PRINTFORMW 「いかに素粒子同士の動きがあったとしてもこの紐付けされた赤い糸だけはね」	PRINTFORMW 「无论基本粒子如何运动、我们之间的红线也不会变」
PRINTFORMW そう言いながら彼女は%CALLNAME:MASTER%の顔をまじまじと見つめてくる。	PRINTFORMW 一边这样说着、她一边认真地盯着%CALLNAME:MASTER%的脸。
PRINTFORMW 「%CALLNAME:MASTER%の顔、月を見るより遙かに素敵だわ」	PRINTFORMW 「%CALLNAME:MASTER%的脸、比月亮还要美丽」
PRINTFORMW 蓮子はそのまま%CALLNAME:MASTER%の唇を奪い、満足そうに微笑んだ。	PRINTFORMW 蓮子就这样夺走了%CALLNAME:MASTER%的嘴唇、满足的微笑着。
PRINTFORMW 「あら？予想外ね……」	PRINTFORMW 「啊？意料之外啊……」
PRINTFORMW 蓮子はそう言いながら少し不思議そうにしている。	PRINTFORMW 蓮子一边这么说一边觉得有点不可思议。
PRINTFORMW 「プランク並の脳みその私を振るだなんて覚悟しなさいよ？」	PRINTFORMW 「把拥有能和普朗克相提并论的头脑的我甩掉、你做好觉悟了吗？」
PRINTFORMW 「じゃあね！！！」	PRINTFORMW 「再见！！！」
PRINTFORMW 蓮子は怒りながら帰っていった。	PRINTFORMW 蓮子生气地回去了。
PRINTFORMW 「今日はもう帰るけど、浮気しちゃダメだからね？」	PRINTFORMW 「今天我就先回去了、不过、不能出轨哟？」
PRINTFORMW 蓮子は名残惜し気に別れて行った。	PRINTFORMW 蓮子恋恋不舍地走了。
PRINTFORMW 「帰るわ、帰ればまた会えるものね」	PRINTFORMW 「我要回去了、回去之后还能再见面吧」
PRINTFORMW 「じゃあ、メリーが待ってるし帰るわ」	PRINTFORMW 「那么、梅莉在等我、我先回去了」
PRINTFORMW 「それじゃあ、バイバイ」	PRINTFORMW 「那么就、拜拜」
PRINTFORMW 「あーごめん、今忙しいの」	PRINTFORMW 「对不起，我现在很忙」
PRINTFORMW 「……用事なんて無いと思うんだけど」	PRINTFORMW 「……我找你没什么事」
PRINTFORMW 「%CALLNAME:MASTER%、顔を見れて安心したわ」	PRINTFORMW 「%CALLNAME:MASTER%、看到你的脸我就安心了」
PRINTFORMW 「%CALLNAME:MASTER%、私達の運命は巡り会うことになっていたのよ？」	PRINTFORMW 「%CALLNAME:MASTER%、我们的相遇是命中注定的对吧？」
PRINTFORMW 蓮子は手を振りながら%CALLNAME:MASTER%に挨拶をした。	PRINTFORMW 蓮子挥手向%CALLNAME:MASTER%打招呼。
PRINTFORMW 「ようやく見つけたわ、どこに行ってたの？」	PRINTFORMW 「终于找到了、你去哪里了？」
PRINTFORMW 「%CALLNAME:MASTER%、元気にしてるわね」	PRINTFORMW 「%CALLNAME:MASTER%、看起来很有精神啊」
PRINTFORMW 「%CALLNAME:MASTER%、今日も快調みたいね」	PRINTFORMW 「%CALLNAME:MASTER%、今天好像过得也很顺利呢」
PRINTFORMW 「%CALLNAME:MASTER%、今日は何してるの？」	PRINTFORMW 「%CALLNAME:MASTER%、今天在干什么？」
PRINTFORMW 「%CALLNAME:MASTER%、元気そうだけど何かあった？」	PRINTFORMW 「%CALLNAME:MASTER%、你看起来很有精神的样子是有什么好事吗？」
PRINTFORMW 「%CALLNAME:MASTER%、面白い物でも見つけたかしら？」	PRINTFORMW 「%CALLNAME:MASTER%、找到什么有趣的东西了吗？」
PRINTFORMW 「%CALLNAME:MASTER%、ごきげんよう、良い日になると良いわね」	PRINTFORMW 「%CALLNAME:MASTER%、你好、希望今天是个好日子」
PRINTFORMW 「あら、%CALLNAME:MASTER%、奇遇ねこんなところで」	PRINTFORMW 「あら、%CALLNAME:MASTER%、真是巧遇啊在这种地方」
PRINTFORMW 「%CALLNAME:MASTER%と会うなんて素粒子の導きかしらね？」	PRINTFORMW 「%CALLNAME:MASTER%和你见面是基本粒子的引导吗？」
PRINTFORMW 「%CALLNAME:MASTER%、どうしたの珍しい物でも見るような顔して？」	PRINTFORMW 「%CALLNAME:MASTER%、怎么一副见到稀奇东西的表情？」
PRINTFORMW 「あら、%CALLNAME:MASTER%の方が先だったのね」	PRINTFORMW 「啊啦、%CALLNAME:MASTER%先来了啊」
PRINTFORMW 「構わないわ、恋人なんだもの♪」	PRINTFORMW 「没关系的、我们是恋人嘛♪」
PRINTFORMW 「%CALLNAME:MASTER%に一番風呂は取られたみたいね」	PRINTFORMW 「%CALLNAME:MASTER%把第一个泡澡的名额拿走了啊」
PRINTFORMW そう言うと蓮子は浴場へ入ってきた。	PRINTFORMW 这么说着、蓮子走进了浴场。
PRINTFORMW 「いいわよ、気にしない、気にしない！」	PRINTFORMW 「好啦、我不介意、不介意！」
PRINTFORMW 「えっ、入ってたの？」	PRINTFORMW 「诶、你进来了？」
PRINTFORMW 「まあいいわ、こういうのも乙な物ね」	PRINTFORMW 「算了、这样也挺风雅的」
PRINTFORMW 「あちゃー入られてたか……まあいいわ、背中ぐらい流してあげるわよ」	PRINTFORMW 「啊呀、你进来了吗……算了、我就给你洗个背吧」
PRINTFORMW 「こんな美女と混浴できるかもってちょっとは期待してた？」	PRINTFORMW 「和我这样的美女混浴你是不是这样期待了？」
PRINTFORMW 「仕方ないわ、しばらく待つからさっさと上がってよね」	PRINTFORMW 「真没办法、等我一会、你先出去」
PRINTFORMW 「ごめんごめん、入ってるの確認してなかったわ」	PRINTFORMW 「抱歉抱歉、我没确认就进来了」
PRINTFORMW 「……お邪魔しましたー」	PRINTFORMW 「……打扰了」
PRINTFORMW 「混浴はまたの機会にね%UNICODE(0x2665) *1%」	PRINTFORMW 「下次有机会再混浴吧%UNICODE(0x2665) *1%」
PRINTFORMW 「ごめーん、今一人で入りたいの！」	PRINTFORMW 「抱歉、现在我想一个人洗！」
PRINTFORMW 「悪いけど一人にしてくれる？」	PRINTFORMW 「不好意思能让我一个人呆着吗？」
PRINTFORMW 「ほらほら、さっさと上がった上がった」	PRINTFORMW 「好啦好啦、动作快点出去出去」
PRINTFORMW 「……何よ色目使っちゃって」	PRINTFORMW 「……干嘛往这里送秋波」
PRINTFORMW 「私が用済みだから当てつけって事！？」	PRINTFORMW 「说什么我有急事就是这种事吗！？」
PRINTFORMW 「……頭おかしくなりそう……」	PRINTFORMW 「……脑子要变得不正常了……」
PRINTFORMW 「……そういうことするんだ」	PRINTFORMW 「……在做这种事啊」
PRINTFORMW 「……まあ他人の色恋沙汰なんてね」	PRINTFORMW 「……唉、别人的情爱什么的」
PRINTFORMW 「そういう相手が居るのね%CALLNAME:MASTER%」	PRINTFORMW 「有这样的对象啊%CALLNAME:MASTER%」
PRINTFORMW 「へぇ、そっかー」	PRINTFORMW 「诶、这样啊」
PRINTFORMW 蓮子は少しニヤニヤしながらこちらを見つめている。	PRINTFORMW 莲子微笑着看着这边。
PRINTFORMW 「明けましておめでとう！%CALLNAME:MASTER%！」	PRINTFORMW 「新年快乐！%CALLNAME:MASTER%！」
PRINTFORMW 蓮子はそう言って新年の挨拶をしてきた。	PRINTFORMW 蓮子这样说着新年的问候。
PRINTFORMW 「今年もよろしくね！」	PRINTFORMW 「今年也请多多关照！」
PRINTFORMW 蓮子は新年の挨拶をしてきた。	PRINTFORMW 蓮子做了新年的问候。
PRINTFORMW 「%CALLNAME:MASTER%に会えるなんて幸先がいいわね！」	PRINTFORMW 「能遇到%CALLNAME:MASTER%真是吉兆啊！」
PRINTFORMW 「今年も秘封倶楽部をよろしくね！」	PRINTFORMW 「今年也请多关照秘封倶楽部！」
PRINTFORMW 「明けましておめでとう！今年もいい年だといいわね！」	PRINTFORMW 「新年快乐！希望今年也是个好年！」
PRINTFORMW 「%CALLNAME:MASTER%、今日はバレンタインだよね」	PRINTFORMW 「%CALLNAME:MASTER%、今天是情人节吧」
PRINTFORMW 蓮子はおずおずと%CALLNAME:MASTER%に話しかけてきた	PRINTFORMW 蓮子结结巴巴地和%CALLNAME:MASTER%搭话
PRINTFORMW 「%CALLNAME:MASTER%、今日は渡す物があるの」	PRINTFORMW 「%CALLNAME:MASTER%、今天有东西要交给你」
PRINTFORMW 「%CALLNAME:MASTER%、待って頂戴」	PRINTFORMW 「%CALLNAME:MASTER%、请等一下」
PRINTFORMW 「%CALLNAME:MASTER%、渡したいものがあるからちょっと待って」	PRINTFORMW 「%CALLNAME:MASTER%、我有想给你的东西、稍微等一下」
PRINTFORMW 「はい、チョコレート」	PRINTFORMW 「给、巧克力」
PRINTFORMW 蓮子はチョコレートを渡してきた。	PRINTFORMW 蓮子把巧克力递了过来。
PRINTFORMW 「義理チョコだけどね、感謝しなさい？」	PRINTFORMW 「只是义理巧克力、要感谢我哦？」
PRINTFORMW 蓮子は%CALLNAME:MASTER%にチョコレートを渡してきた。	PRINTFORMW 蓮子把巧克力递给了%CALLNAME:MASTER%。
PRINTFORMW 「ここだと手に入りにくいんだけどね……ま、感謝しなさい？」	PRINTFORMW 「这个在这里很难入手的……嘛、要感谢我哦？」
PRINTFORMW 少し恥ずかしそうに彼女はそそくさと離れて行った。	PRINTFORMW 她看起来有些害羞的匆匆离开了。
PRINTFORMW 「これ、作ったの」	PRINTFORMW 「我做了、这个」
PRINTFORMW そう言いながら蓮子はチョコレートを渡してきた。	PRINTFORMW 这么说着蓮子把巧克力递给了我。
PRINTFORMW 「ちゃんと味は確かめてあるから味わって食べるといいわよ？」	PRINTFORMW 「我试过味道了、要好好的品尝哦？」
PRINTFORMW 「高かったんだから感謝してよね？」	PRINTFORMW 「这个很贵的要感谢我啊？」
PRINTFORMW 「私も同じの食べたけど美味しかったから安心していいわよ」	PRINTFORMW 「我吃过一样的、很好吃、你可以放心哦」
PRINTFORMW 「%CALLNAME:MASTER%、トリックオアトリート！」	PRINTFORMW 「%CALLNAME:MASTER%、不给糖就捣蛋！」
PRINTFORMW 蓮子は%CALLNAME:MASTER%に朗らかに話しかけてくる。	PRINTFORMW 蓮子开朗地和%CALLNAME:MASTER%搭话。
PRINTFORMW 「百鬼夜行の日だけど私たちはどうする・」	PRINTFORMW 「虽然是百鬼夜行的日子、但我们要做什么呢・」
PRINTFORMW 「トリック・オア・トリート！」	PRINTFORMW 「不给糖・就・捣蛋！」
PRINTFORMW 蓮子はそう言いながら話しかけてきた。	PRINTFORMW 蓮子一边这样说着一边跟我搭话。
PRINTFORMW 「今日はお菓子だけじゃないけど何かしてくれる？」	PRINTFORMW 「今天除了吃糖果我们还要做些什么？」
PRINTFORMW 蓮子は%CALLNAME:MASTER%の後ろから呟いた。	PRINTFORMW 蓮子在%CALLNAME:MASTER%身后嘟囔着。
PRINTFORMW 「不思議な夜ね、人間なのにワクワクしちゃうわ」	PRINTFORMW 「真是不可思议的夜晚、明明是人类却兴奋起来了」
PRINTFORMW 蓮子はそう言って脅かしてきた。	PRINTFORMW 蓮子这样说着威胁过来。
PRINTFORMW 「折角の魑魅魍魎の日よ！楽しんでいきましょう！」	PRINTFORMW 「难得的魑魅魍魉之日！好好享受吧！」
PRINTFORMW 「%CALLNAME:MASTER%、メリークリスマス%UNICODE(0x2665) *1%」	PRINTFORMW 「%CALLNAME:MASTER%、圣诞快乐%UNICODE(0x2665) *1%」
PRINTFORMW 蓮子は嬉しそうに%CALLNAME:MASTER%に話しかけてくる。	PRINTFORMW 蓮子很高兴地与%CALLNAME:MASTER%搭话。
PRINTFORMW 「クリスマスだし恋人らしいことしましょうよ」	PRINTFORMW 「因为是圣诞节、所以做点像恋人一样的事吧」
PRINTFORMW 「%CALLNAME:MASTER%、メリークリスマス！」	PRINTFORMW 「%CALLNAME:MASTER%、圣诞快乐！」
PRINTFORMW 蓮子はそう言って話しかけてきた。	PRINTFORMW 蓮子这样说着跟我搭话。
PRINTFORMW 「暇なら付き合ってよ、今日は楽しい日よ？」	PRINTFORMW 「有空的话就陪陪我吧、今日是快乐的一天？」
PRINTFORMW 「あら？こんな美人のサンタでも不満？」	PRINTFORMW 「啊拉？你对这么漂亮的圣诞老人有什么不满吗？」
PRINTFORMW 「メリークリスマス、%CALLNAME:MASTER%！」	PRINTFORMW 「圣诞快乐、%CALLNAME:MASTER%！」
PRINTFORMW 「プレゼントは貰えるかしら？」	PRINTFORMW 「能收到礼物吗？」
PRINTFORMW 「あら、%CALLNAME:MASTER%、おはよう%UNICODE(0x2665) *1%」	PRINTFORMW 「啊拉、%CALLNAME:MASTER%、早上好%UNICODE(0x2665) *1%」
PRINTFORMW 蓮子は嬉しそうに%CALLNAME:MASTER%に朝の挨拶をしてきた。	PRINTFORMW 蓮子高兴地向%CALLNAME:MASTER%做早上的问候。
PRINTFORMW 「私より朝が弱いなんて可愛いわね♪」	PRINTFORMW 「比我还难起床什么的真可爱♪」
PRINTFORMW 「%CALLNAME:MASTER%、起きた？」	PRINTFORMW 「%CALLNAME:MASTER%、起床了吗？」
PRINTFORMW 蓮子はそう言って朝の挨拶をしてきた。	PRINTFORMW 蓮子这样说着做了早上的问候。
PRINTFORMW 「寝坊してもいいのよ？すっぴん見られたくないしね」	PRINTFORMW 「睡懒觉也没关系哦？我也不想被看到素颜呢」
PRINTFORMW 「%CALLNAME:MASTER%、おはよう」	PRINTFORMW 「%CALLNAME:MASTER%、早上好」
PRINTFORMW 「よく眠れたかしら？私はほら、ショートスリーパーってやつ？ね」	PRINTFORMW 「睡得好吗？我吗？我就是所谓的短睡眠者？呐」
PRINTFORMW 「おはよう、朝は味噌汁に限るわね」	PRINTFORMW 「早上好、早上的选择果然是味增汤啊」
PRINTFORMW 蓮子はそう言いながらにこやかに笑っている。	PRINTFORMW 蓮子这么说着露出了满面笑容。
PRINTFORMW 「ん―――」	PRINTFORMW 「嗯―――」
PRINTFORMW 蓮子は幸せそうに眠りこけている。	PRINTFORMW 蓮子看着睡得很幸福。
PRINTFORMW 「貴方のことも好きよ」	PRINTFORMW 「我也喜欢你」
PRINTFORMW 「んん？」	PRINTFORMW 「嗯嗯？」
PRINTFORMW 蓮子は眠りこけている。	PRINTFORMW 蓮子睡得很香。
PRINTFORMW 「いつだって隣に居るわよ」	PRINTFORMW 「要一直在我身边哟」
PRINTFORMW 「……とりあえずメリーの見た結界に……」	PRINTFORMW 「……总之对梅莉看到的那个结界……」.
PRINTFORMW 蓮子はぐっすりと眠りこけている。	PRINTFORMW 蓮子睡得不省人事。
PRINTFORMW 「……んん……」	PRINTFORMW 「……嗯嗯……」
PRINTFORMW 蓮子は寝息も立てず眠りこけている。	PRINTFORMW 蓮子睡得不省人事。
PRINTFORMW 「んん……早起きね、%CALLNAME:MASTER%」	PRINTFORMW 「嗯嗯……起的真早呢、%CALLNAME:MASTER%」
PRINTFORMW 「時間にルーズなのは知ってるでしょ？あまり見ないで欲しいわね」	PRINTFORMW 「你知道我不守时吧？希望你不要看太多」
PRINTFORMW 「ん……もう朝……？」	PRINTFORMW 「嗯……已经早上了……？」
PRINTFORMW 「ん……帰ってきたのね……」	PRINTFORMW 「嗯……你回来了啊……」
PRINTFORMW 「お休み、%CALLNAME:MASTER%」	PRINTFORMW 「晚安、%CALLNAME:MASTER%」
PRINTFORMW 「……場所変えよっか」	PRINTFORMW 「……换个地方吧」
PRINTFORMW 「へえ……こういうことをするのね男って」	PRINTFORMW 「呃……男人会做这种事情啊」
PRINTFORMW （こんど探してみよっかなこんな下着……）	PRINTFORMW （下次再找找看吧这样的内衣……）
PRINTFORMW 「ねえ、%CALLNAME:MASTER%」	PRINTFORMW 「喂、%CALLNAME:MASTER%」
PRINTFORMW %CALLNAME:MASTER%の名を呼びながら蓮子は%CALLNAME:MASTER%を押し倒した。	PRINTFORMW 莲子一边叫着%CALLNAME:MASTER%的名字一边把%CALLNAME:MASTER%推倒了。
PRINTFORMW 「ん、たまにはいいでしょ私からしても」	PRINTFORMW 「嗯、偶尔也可以吧从我这边开始」
PRINTFORMW そう言いながら蓮子は%CALLNAME:MASTER%の服を脱がし、肌を密着させてくる。	PRINTFORMW 这么说着蓮子脱下了%CALLNAME:MASTER%的衣服、互相紧贴着肌肤。
PRINTFORMW 「私だけを見て……%UNICODE(0x2665) *1%」	PRINTFORMW 「看着我……%UNICODE(0x2665) *1%」
PRINTFORMW 「%CALLNAME:MASTER%、こういうのは慣れてないけど」	PRINTFORMW 「%CALLNAME:MASTER%、这种事情我虽然不是很习惯」
PRINTFORMW 蓮子は笑みを浮かべながら%CALLNAME:MASTER%に密着してくる。	PRINTFORMW 蓮子面带笑容的紧贴着%CALLNAME:MASTER%。
PRINTFORMW 「優しくしてあげるわよ……%CALLNAME:MASTER%%UNICODE(0x2665) *1%」	PRINTFORMW 「我会对你温柔的……%CALLNAME:MASTER%%UNICODE(0x2665) *1%」
PRINTFORMW そう言いながら彼女は%CALLNAME:MASTER%に優しくキスをしてきた。	PRINTFORMW 这么说着她温柔的亲吻了%CALLNAME:MASTER%。
PRINTFORMW 「ねえ%CALLNAME:MASTER%」	PRINTFORMW 「喂%CALLNAME:MASTER%」
PRINTFORMW 蓮子は%CALLNAME:MASTER%を組み敷くと	PRINTFORMW 蓮子把%CALLNAME:MASTER%压在了身下
PRINTFORMW 「駄目ね、男ってのは女を組み敷いて犯す物よ、これじゃ逆じゃない？」	PRINTFORMW 「不行呐、所谓的男人就是把女人压在身下侵犯的东西、这样不是反了吗？」
PRINTFORMW 蓮子は%CALLNAME:MASTER%を愛撫しながら情欲を誘っている。	PRINTFORMW 蓮子一边爱抚着%CALLNAME:MASTER%一边引诱着情欲。
PRINTFORMW 「仕方ないわね……」	PRINTFORMW 「真没办法……」
PRINTFORMW 「駄目じゃない、抜け出すなんて」	PRINTFORMW 「不行啊、溜走什么的」
PRINTFORMW 「駄目じゃない、女の子が満足してないのに……%UNICODE(0x2665) *1%」	PRINTFORMW 「不行啊、明明女孩子还没有满足……%UNICODE(0x2665) *1%」
PRINTFORMW 「こんなところでもレポートを書かないとね」	PRINTFORMW 「就算在这里、也还是要写报告呢」
PRINTFORMW 「今日あった出来事をまとめないとね」	PRINTFORMW 「我得把今天发生的事情总结一下」
PRINTFORMW 「外の世界に帰ったら同人誌でも出そうかしら？」	PRINTFORMW 「回到外面的世界的话、要不要出个同人志呢？」
PRINTFORMW 「電子……もっと言えば素粒子単位で言えば私たちも確実に存在しているし、互いの影響を受けるのよねぇ」	PRINTFORMW 「电子……再进一步说、以基本粒子为单位来说、我们确实是存在的、我们也会受到互相的影响。」
PRINTFORMW 「万物が素粒子の動きで表せるとしたらその動きを体系的に表現できるんだけどね」	PRINTFORMW 「如果万物都能用基本粒子的运动来表现的话、就可以系统性地表现出它的运动了」
PRINTFORMW 「メリー、そこのペン取ってくれる？」	PRINTFORMW 「梅莉、能把那边的笔拿给我吗？」
PRINTFORMW 「メリーもお疲れね」	PRINTFORMW 「梅莉也辛苦了」
PRINTFORMW 「あー、書いた書いた、寝よっと！」	PRINTFORMW 「啊--、写完了写完了、睡吧！」
PRINTFORMW 「いい頃合いね、休憩しよっか」	PRINTFORMW 「正好是时候、休息一下吧」
PRINTFORMW 「んっ%UNICODE(0x2665) *1%」	PRINTFORMW 「呜%UNICODE(0x2665) *1%」
PRINTFORMW 「……次はもっとね%UNICODE(0x2665) *1%」	PRINTFORMW 「……下次要做得更多呐%UNICODE(0x2665) *1%」
PRINTFORMW 「んっ……まだ繋がっていたいけど……」	PRINTFORMW 「呜……虽然还想继续相连着……」
PRINTFORMW 蓮子は名残惜しげに体を離していった。	PRINTFORMW 蓮子恋恋不舍地分开了身体。
PRINTFORMW 「……いいわ、これぐらいにしてあげる%UNICODE(0x2665) *1%」	PRINTFORMW 「……好吧、先放过你吧%UNICODE(0x2665) *1%」
PRINTFORMW 「……馬鹿」	PRINTFORMW 「……笨蛋」
PRINTFORMW 「……避妊ぐらいしろ！」	PRINTFORMW 「……避孕什么的至少要做啊！」
PRINTFORMW 「生……？」	PRINTFORMW 「不戴……？」
PRINTFORMW 「えーちょっとそれは覚悟できてないって言うか……」	PRINTFORMW 「额、那个我还没有做好觉悟的说……」
PRINTFORMW 「……ゴムぐらいつけてよ」	PRINTFORMW 「……避孕套戴上啊」
PRINTFORMW 「嫌よ、避妊はマナーよ」	PRINTFORMW 「才不要、避孕是礼仪啊」
PRINTFORMW 「この……！いい加減にして！」	PRINTFORMW 「你这……！给我适可而止！」
PRINTFORMW 「駄目って言ってるのに……」	PRINTFORMW 「明明说了不行的……」
PRINTFORMW 「だから駄目よ」	PRINTFORMW 「所以说不行啊」
PRINTFORMW 「……責任も取る気ないくせに」	PRINTFORMW 「……明明连责任都不想承担」
PRINTFORMW 「やめてよ！」	PRINTFORMW 「别这样！」
PRINTFORMW 蓮子は怒気を孕んだ声で拒絶している。	PRINTFORMW 蓮子用充满怒气的声音拒绝了。
PRINTFORMW 「……いいけど」	PRINTFORMW 「……好吧」
PRINTFORMW 「もっと気持ちよくしてよ？」	PRINTFORMW 「要让我更舒服哟？」
PRINTFORMW 「……分かったわよ」	PRINTFORMW 「……明白了」
PRINTFORMW 「でも危険日は駄目だからね！ちゃんと守ってよ？」	PRINTFORMW 「但是危险日还是不行的！要好好遵守啊？」
PRINTFORMW 「……仕方ないわね……」	PRINTFORMW 「……真拿你没办法……」
PRINTFORMW 「ふぅん、でも生ハメって気持ちいいって言うしね」	PRINTFORMW 「嗯姆、的确听说不戴套很舒服」
PRINTFORMW 「いいわ、でも責任取ってよね%UNICODE(0x2665) *1%」	PRINTFORMW 「好吧、但是你要负起责任哦%UNICODE(0x2665) *1%」
PRINTFORMW 「……いいわよ」	PRINTFORMW 「……好吧」
PRINTFORMW 「まあでも責任は取ってね%UNICODE(0x2665) *1%」	PRINTFORMW 「不过你要负起责任哦%UNICODE(0x2665) *1%」
PRINTFORMW 「……好きにすればいいじゃない」	PRINTFORMW 「……就随你喜欢就行了」
PRINTFORMW 「ふふっ、これで公認の関係ね、%CALLNAME:MASTER%」	PRINTFORMW 「呜呼、这样我们就是公认的关系啦、%CALLNAME:MASTER%」
PRINTFORMW 「私たちの運命の糸は切れないのよ、素粒子単位でね」	PRINTFORMW 「我们之间的命运之线是不会断的、就算以基本粒子为单位」
PRINTFORMW 蓮子は満足そうな笑みを浮かべこちらを見つめている。	PRINTFORMW 蓮子露出满足的笑容凝视着这边。
PRINTFORMW 「……それにしても同棲ってのは気を使うわよね」	PRINTFORMW 「……话说回来、同居可是很费心的」
PRINTFORMW 「安心して、私は懐が深いから」	PRINTFORMW 「不过放心吧、我的胸怀很宽广的」
PRINTFORMW 「えー……！駄目か……」	PRINTFORMW 「诶……！不行吗……」
PRINTFORMW 「……帰るわよ、じゃあね」	PRINTFORMW 「……我回去了、再见」
PRINTFORMW 蓮子はいつの間にか帰っていった。	PRINTFORMW 蓮子不知道什么时候回去了。
PRINTFORMW 「今日はもう帰るわよ」	PRINTFORMW 「今天我要回去了」
PRINTFORMW 「……折角だから夢でも会いましょうね」	PRINTFORMW 「……难得有机会、在梦里也见个面吧」
PRINTFORMW 「もう帰るわ、じゃあね、%CALLNAME:MASTER%」	PRINTFORMW 「我回去了、再见、%CALLNAME:MASTER%」
PRINTFORMW 「そろそろ帰るわね、%CALLNAME:MASTER%」	PRINTFORMW 「差不多到了回去的时间了、%CALLNAME:MASTER%」
PRINTFORMW 「それじゃあ帰るわね」	PRINTFORMW 「那么我就回去了」
PRINTFORMW 「……飽きたわ」	PRINTFORMW 「……我受够了」
PRINTFORMW 「今日はお開きね、夢の中でも続きができたらいいのだけど」	PRINTFORMW 「今天就到这结束了、即使是在梦中也想就这样继续下去」
PRINTFORMW 「今日は楽しかったわ！またデートしましょっか」	PRINTFORMW 「今天玩的很开心!我们以后再约会吧」
PRINTFORMW 「そうね、もう時間だわ、じゃあね」	PRINTFORMW 「是啊、时间到了、再见」
PRINTFORMW 「また今度遊びましょうね」	PRINTFORMW 「下次再一起玩吧」
PRINTFORMW 「気持ち悪いからここでいいんだけど」	PRINTFORMW 「真不舒服就到这里吧」
PRINTFORMW 蓮子は怒りながら去っていった。	PRINTFORMW 蓮子愤怒地离开了。
PRINTFORMW 「ありがと、次は私が迎えに来るからね♪」	PRINTFORMW 「谢谢、下次就由我去迎接你♪」
PRINTFORMW 「送りオオカミには気を付けるから大丈夫よ」	PRINTFORMW 「我会小心的、不用担心」
PRINTFORMW 「意外と紳士的なね%CALLNAME:MASTER%」	PRINTFORMW 「意外的很绅士呢%CALLNAME:MASTER%」
PRINTFORMW 「わざわざどうも」	PRINTFORMW 「谢谢你特意送我」
PRINTFORMW 蓮子は帰宅するとそのまま布団に倒れこんだ。	PRINTFORMW 蓮子一回家就直接倒在了被子上。
PRINTFORMW 「あんな変な奴に……」	PRINTFORMW 「被那样奇怪的家伙给……」
PRINTFORMW 彼女は空を掴むように天井に手を伸ばしながらそうつぶやいた。	PRINTFORMW 她就像要抓住天空一样把手伸向天花板、一边在嘴里嘟囔着。
PRINTFORMW 「例え夢の中でも私は%CALLNAME:MASTER%の事を……」	PRINTFORMW 「即使在梦中我也在想着%CALLNAME:MASTER%的事……」
PRINTFORMW 全てが素粒子で表されるのなら全てが0と1でも本物よね。	PRINTFORMW 如果一切事物都能用基本粒子的运动表示的话、那即使全是0和1也是真的。
PRINTFORMW あるいは虚構の世界でも運命の赤い糸で繋がっているのならやることは一つに過ぎない。	PRINTFORMW 又或者说即使是虚构的世界、只要被命运的红线连接起来、那要做的事也只有一件。
PRINTFORMW 彼女は思考にピリオドを打ち、そのままもう一つの世界へ旅立っていった。	PRINTFORMW 她为思考画上了句号、就这样踏上了去往另一个世界的旅程。
PRINTFORMW 「……変な目してたわね……まるでメリーみたい」	PRINTFORMW 「……真是奇怪的眼睛……就像梅莉一样」
PRINTFORMW どこかの誰かを意識した思考を放棄し、彼女はそのまま眠りに落ちていった。	PRINTFORMW 她放弃了对某个人的思考、就这样睡着了。
PRINTFORMW （%CALLNAME:MASTER%……気になるわ）	PRINTFORMW （%CALLNAME:MASTER%……好在意啊）
PRINTFORMW 「んんっ……んんんっ……%UNICODE(0x2665) *1%」	PRINTFORMW 「嗯啊……嗯嗯嗯啊……%UNICODE(0x2665) *1%」
PRINTFORMW 蓮子は情欲に苛まれながら床についた。	PRINTFORMW 莲子在情欲的折磨下躺在床上。
PRINTFORMW 「はぁっ……%CALLNAME:MASTER%……%UNICODE(0x2665) *1%」	PRINTFORMW 「哈啊……%CALLNAME:MASTER%……%UNICODE(0x2665) *1%」
PRINTFORMW 彼女はどこか虚ろな目で秘部に手を伸ばしながらぼうっと空を見つめている。	PRINTFORMW 她茫然地望着天空、眼神空洞、手伸向秘部。
PRINTFORMW 自分が淫乱であったということを受け入れながら彼女は%CALLNAME:MASTER%の事を脳裏に浮かべていた。	PRINTFORMW 她一边接受自己是淫乱的事实一边在脑海里浮现出%CALLNAME:MASTER%的样子。
PRINTFORMW 「ふふっ、%CALLNAME:MASTER%……%UNICODE(0x2665) *1%」	PRINTFORMW 「呜呼、%CALLNAME:MASTER%……%UNICODE(0x2665) *1%」
PRINTFORMW 「……いいのよ、これで……%UNICODE(0x2665) *1%」	PRINTFORMW 「……没关系、就这样吧……%UNICODE(0x2665) *1%」
PRINTFORMW そう言って蓮子は愛人関係を受け入れた。	PRINTFORMW 这么说着、蓮子接受了愛人关系。
PRINTFORMW 「……んんっ……！」	PRINTFORMW 「……嗯嗯啊……！」
PRINTFORMW 彼女はそう言いながら下半身に手を伸ばしている。	PRINTFORMW 她一边说着一边把手伸向下半身。
PRINTFORMW 「……こんなにしたんだから……%UNICODE(0x2665) *1%」	PRINTFORMW 「……做了这么多……%UNICODE(0x2665) *1%」
PRINTFORMW 指に付いた愛液を眺めながら蓮子は淫らに堕ちていった。	PRINTFORMW 望着沾染在指上的爱液、蓮子向着淫荡堕落了。
PRINTFORMW 「あっ……%UNICODE(0x2665) *1%んんっ……%CALLNAME:MASTER%……%UNICODE(0x2665) *1%」	PRINTFORMW 「啊……%UNICODE(0x2665) *1%嗯嗯啊……%CALLNAME:MASTER%……%UNICODE(0x2665) *1%」
PRINTFORMW 「んっ……メリー……%UNICODE(0x2665) *1%」	PRINTFORMW 「嗯啊……梅莉……%UNICODE(0x2665) *1%」
PRINTFORMW 「%CALLNAME:MASTER%！遊びに行きましょう！」	PRINTFORMW 「%CALLNAME:MASTER%！一起去玩吧！」
PRINTFORMW 「%CALLNAME:MASTER%、暇なら結界暴きにでも行かない？	PRINTFORMW 「%CALLNAME:MASTER%、有空的话一起去探寻结界怎么样？
PRINTFORMW 「%CALLNAME:MASTER%、デートしない？」	PRINTFORMW 「%CALLNAME:MASTER%、不去约会吗？」
PRINTFORMW 「%CALLNAME:MASTER%、ちょっと付き合ってくれない？」	PRINTFORMW 「%CALLNAME:MASTER%、能陪我一会么？」
PRINTFORMW 「この前面白い場所を見つけたのよ、%CALLNAME:MASTER%と行きたくてね♪」	PRINTFORMW 「我之前发现了一个有趣的地方想和%CALLNAME:MASTER%一起去♪」
PRINTFORMW 「さあ、どこの結界を見に行きましょうか？」	PRINTFORMW 「那么、要去看哪里的结界呢？」
PRINTFORMW 「せっかくのデートだし楽しまないとね」	PRINTFORMW 「难得的约会可不能不开心啊」
PRINTFORMW 「……メリーも誘えば良かったかしら」	PRINTFORMW 「……要不把梅莉也叫上吧」
PRINTFORMW 「えーじゃあ今度ね……」	PRINTFORMW 「唉那就下次吧……」
PRINTFORMW 「あら？興味ない感じ？」	PRINTFORMW 「啊拉？没有兴趣？」
PRINTFORMW 「へー私の誘いを断るなんてね」	PRINTFORMW 「你竟然拒绝我的邀请」
PRINTFORMW 「じゃあメリーを誘うとしますか」	PRINTFORMW 「那我就去邀请梅莉吧」
PRINTFORMW 「%CALLNAME:MASTER%、ねえ私の部屋に来ない？」	PRINTFORMW 「%CALLNAME:MASTER%、要来我房间吗？」
PRINTFORMW 「%CALLNAME:MASTER%、ちょっと見せたい物があるんだけど」	PRINTFORMW 「%CALLNAME:MASTER%、我有些东西想给你看看」
PRINTFORMW 「%CALLNAME:MASTER%、少し寄ってかない？」	PRINTFORMW 「%CALLNAME:MASTER%、能稍微过来一下吗？」
PRINTFORMW 「%CALLNAME:MASTER%、暇なら寄ってくる？」	PRINTFORMW 「%CALLNAME:MASTER%、有空的话能过来一下吗？」
PRINTFORMW 「いいの？今夜は寝かさないからね%UNICODE(0x2665) *1%」	PRINTFORMW 「可以吗？今晚不会让你睡的哦%UNICODE(0x2665) *1%」
PRINTFORMW 「いい物見つけたのよ、夢の中でね」	PRINTFORMW 「找到了好东西哦、虽然是在梦中找到的」
PRINTFORMW 「……変な期待しちゃダメよ？」	PRINTFORMW 「……不要抱有什么奇怪的期待哦？」
PRINTFORMW 「せっかくだし茶ぐらい出すわよ」	PRINTFORMW 「难得你来、上杯茶这种程度我还是会做的哦」
PRINTFORMW 「へえ、他に用事があるのね？」	PRINTFORMW 「诶、是有其他事情要做吗？」
PRINTFORMW 「……またの機会にするわ」	PRINTFORMW 「……那下次有机会再来吧」
PRINTFORMW 「せっかく女の子の部屋に入れるのに堅物ね」	PRINTFORMW 「好不容易有进女孩子的房间的机会、真是死板啊」
PRINTFORMW 「あら？メリーなら喜んで入るのに」	PRINTFORMW 「啊拉？明明梅莉就会高兴的进来」
PRINTFORMW 「ほら、%CALLNAME:MASTER%も脱ぎなさいよ！」	PRINTFORMW 「来吧、%CALLNAME:MASTER%也脱下来吧！」
PRINTFORMW 「ん、恥ずかしいわね……」	PRINTFORMW 「嗯、真不好意思啊……」
PRINTFORMW 「もう、せっかちなんだから……！」	PRINTFORMW 「真是的、真是个性急的家伙呀……！」
PRINTFORMW 「そうね、それなら交換ね」	PRINTFORMW 「是呢、那我们就交换吧」
PRINTFORMW 「いいわよ、私の下着でたっぷり抜きなさい？」	PRINTFORMW 「可以哦、要用我的内衣多多弄出来哦？」
PRINTFORMW 「ええ……？いいけど……」	PRINTFORMW 「诶……？可以哦……」
PRINTFORMW 「何に使う気なのよ……」	PRINTFORMW 「你想用来干什么……」
PRINTFORMW 「馬鹿！！！」	PRINTFORMW 「笨蛋！！！」
PRINTFORMW 「もう無理……疲れた……」	PRINTFORMW 「我不行啦……好累……」
PRINTFORMW 「うん、もういいわ……%UNICODE(0x2665) *1%」	PRINTFORMW 「嗯、足够了……%UNICODE(0x2665) *1%」
PRINTFORMW 「んん！？…もう無理なのに……%UNICODE(0x2665) *1%」	PRINTFORMW 「嗯嗯！？…我、已经不行了……%UNICODE(0x2665) *1%」
PRINTFORMW 「もう！じゃあ覚悟してよね……%UNICODE(0x2665) *1%」	PRINTFORMW 「真是的！那给我做好心理准备吧……%UNICODE(0x2665) *1%」
PRINTFORMW 「あーもう、別に洗うから貸しなさい！」	PRINTFORMW 「啊ー真是的、我来洗把那个借给我吧！」
PRINTFORMW 蓮子はそう言って%CALLNAME:MASTER%の下着を持って行ってしまった。	PRINTFORMW 蓮子这样说着把%CALLNAME:MASTER%的内衣拿走了。
PRINTFORMW 「……ふぅ……全くもう%UNICODE(0x2665) *1%」	PRINTFORMW 「……呼～……真的是%UNICODE(0x2665) *1%」
PRINTFORMW 彼女は%CALLNAME:MASTER%の精液がこびりついた下着に顔を埋めて恍惚としている	PRINTFORMW 她把脸埋在沾满%CALLNAME:MASTER%精液的内衣里露出了恍惚的神情
PRINTFORMW 「うわ……最悪……！」	PRINTFORMW 「哇……糟透了……！」
PRINTFORMW 蓮子は顔をしかめながら%CALLNAME:MASTER%のパンツを捨てた。	PRINTFORMW 蓮子皱着眉头把%CALLNAME:MASTER%的内裤扔掉了。
PRINTFORMW 「んんっ……%UNICODE(0x2665) *1%ダメよ、キスなんて……%UNICODE(0x2665) *1%」	PRINTFORMW 「嗯嗯啊……%UNICODE(0x2665) *1%不行哟，接吻什么的……%UNICODE(0x2665) *1%」
PRINTFORMW 「んっ……こういう肉体的接触も必要ね……%UNICODE(0x2665) *1%」	PRINTFORMW 「嗯啊……这样的肉体接触也是必要的呢……%UNICODE(0x2665) *1%」
PRINTFORMW 「んんっ%UNICODE(0x2665) *1%」	PRINTFORMW 「嗯嗯啊%UNICODE(0x2665) *1%」
PRINTFORMW 「糖分だけじゃなくて%CALLNAME:MASTER%も必要よ%UNICODE(0x2665) *1%」	PRINTFORMW 「我不只需要糖分%CALLNAME:MASTER%也是必要的UNICODE(0x2665) *1%」
PRINTFORMW 「ほら、犯していいわよ%UNICODE(0x2665) *1%」	PRINTFORMW 「来吧、来侵犯我吧%UNICODE(0x2665) *1%」
PRINTFORMW 「挿入れて……%UNICODE(0x2665) *1%」	PRINTFORMW 「插进来……%UNICODE(0x2665) *1%」
PRINTFORMW 「あんまり待たせないで……%UNICODE(0x2665) *1%」	PRINTFORMW 「别让我等太久啊……%UNICODE(0x2665) *1%」
PRINTFORMW 「こっちも疼くんだけど%UNICODE(0x2665) *1%」	PRINTFORMW 「这里也是会疼的啊%UNICODE(0x2665) *1%」
PRINTFORMW 「アナルに挿入れて頂戴%UNICODE(0x2665) *1%」	PRINTFORMW 「给我挿入肛門嘛%UNICODE(0x2665) *1%」
PRINTFORMW 「こっちにも欲しいわ%UNICODE(0x2665) *1%」	PRINTFORMW 「这里也想要哇%UNICODE(0x2665) *1%」
PRINTFORMW 「へぇ？こんなので射精するんだ」	PRINTFORMW 「诶？这样做就会射精啊」
PRINTFORMW 「ん……臭っ」	PRINTFORMW 「嗯……好臭」
PRINTFORMW 「さっさと射精しなさいよ……」	PRINTFORMW 「赶紧射出来吧……」
PRINTFORMW 「ふぅん、まあ慣れたもんよ」	PRINTFORMW 「嗯，已经习惯了」
PRINTFORMW 「さっさと射精すればいいじゃない」	PRINTFORMW 「赶紧射出来不就好了吗」
PRINTFORMW 「なんか少し可愛いかも……」	PRINTFORMW 「感觉有点可爱呀……」
PRINTFORMW 「ほら、さっさとチンポ出しなさい」	PRINTFORMW 「来吧，快点把小鸡鸡拿出来」
PRINTFORMW 「うわ……おっきくなってる……」	PRINTFORMW 「哇……变大了……」
PRINTFORMW 「……こういう海の生物いそうよね」	PRINTFORMW 「……好像某种海里的生物啊」
PRINTFORMW 「ん、ん～～%UNICODE(0x2665) *1%」	PRINTFORMW 「嗯、嗯～～%UNICODE(0x2665) *1%」
PRINTFORMW 蓮子は%CALLNAME:MASTER%の射精を感じ取ると舌使いで巧みにそれを促している。	PRINTFORMW 蓮子感觉到%CALLNAME:MASTER%将要射精用舌头巧妙地催促着。
PRINTFORMW 「んっ%UNICODE(0x2665) *1%ちゅっ%UNICODE(0x2665) *1%んんっ%UNICODE(0x2665) *1%」	PRINTFORMW 「嗯啊%UNICODE(0x2665) *1%啾%UNICODE(0x2665) *1%嗯嗯啊%UNICODE(0x2665) *1%」
PRINTFORMW （ああっ……このの味好きだわ……%UNICODE(0x2665) *1%）	PRINTFORMW （啊啊……我喜欢这个味道……%UNICODE(0x2665) *1%）
PRINTFORMW 「んんっ%UNICODE(0x2665) *1%んっ%UNICODE(0x2665) *1%んんっ%UNICODE(0x2665) *1%」	PRINTFORMW 「嗯嗯啊%UNICODE(0x2665) *1%嗯啊%UNICODE(0x2665) *1%嗯嗯啊%UNICODE(0x2665) *1%」
PRINTFORMW （駄目っ……チンポの臭いと味で何も考えられない……%UNICODE(0x2665) *1%）	PRINTFORMW （不行……满脑子都是鸡巴的味道没办法思考了……%UNICODE(0x2665) *1%）
PRINTFORMW 「んっ……んん……」	PRINTFORMW 「嗯啊……嗯嗯……」
PRINTFORMW （早く射精しなさいよ……%UNICODE(0x2665) *1%）	PRINTFORMW （快点射精吧……%UNICODE(0x2665) *1%）
PRINTFORMW 「んん……早く射精してよ」	PRINTFORMW 「嗯嗯……快点射精吧」
PRINTFORMW 「んんっ%UNICODE(0x2665) *1%ん～%UNICODE(0x2665) *1%」	PRINTFORMW 「嗯嗯啊%UNICODE(0x2665) *1%嗯～%UNICODE(0x2665) *1%」
PRINTFORMW 「ん……%UNICODE(0x2665) *1%んんっ%UNICODE(0x2665) *1%」	PRINTFORMW 「嗯……%UNICODE(0x2665) *1%嗯嗯啊%UNICODE(0x2665) *1%」
PRINTFORMW 「早く射精してよ……%UNICODE(0x2665) *1%」	PRINTFORMW 「快点射精吧……%UNICODE(0x2665) *1%」
PRINTFORMW 「んんっ%UNICODE(0x2665) *1%れろっ%UNICODE(0x2665) *1%んっ%UNICODE(0x2665) *1%」	PRINTFORMW 「嗯嗯啊%UNICODE(0x2665) *1%呸咯%UNICODE(0x2665) *1%嗯啊%UNICODE(0x2665) *1%」
PRINTFORMW 「……あんまり見ないでよ、馬鹿みたいな顔でチンポしゃぶってるとこなんてっ%UNICODE(0x2665) *1%」	PRINTFORMW 「……不要那么死死的盯着啊、我居然一副笨蛋一样的表情榨着精什么的%UNICODE(0x2665) *1%」
PRINTFORMW 「んんっ%UNICODE(0x2665) *1%んんんっ%UNICODE(0x2665) *1%」	PRINTFORMW 「嗯嗯啊%UNICODE(0x2665) *1%嗯嗯嗯啊%UNICODE(0x2665) *1%」
PRINTFORMW （チンポ悦ばせないと……%UNICODE(0x2665) *1%）	PRINTFORMW （不让鸡巴高兴的话……%UNICODE(0x2665) *1%）
PRINTFORMW 「んん～……慣れない味ね」	PRINTFORMW 「嗯嗯～……习惯不了这个味道」
PRINTFORMW 「んん……しょっぱいわね」	PRINTFORMW 「嗯嗯……好咸啊」
PRINTFORMW 「んんっ……どう？私の舌使いは？慣れたもんでしょ」	PRINTFORMW 「嗯嗯啊……怎样？我的舌技？已经很熟练了吧」
PRINTFORMW 「ん……んん……ちゅっ」	PRINTFORMW 「嗯……嗯嗯……啾」
PRINTFORMW （なんでプランク並みの頭を持つ私がこんなことを……）	PRINTFORMW （为什么我这个拥有普朗克一般头脑的人要做这种事……）
PRINTFORMW 「……んっ……れろっ」	PRINTFORMW 「……嗯啊……呸咯」
PRINTFORMW 「……ちゅっ……んっ……」	PRINTFORMW 「……啾……嗯啊……」
PRINTFORMW 「んっ%UNICODE(0x2665) *1%さっさとっ%UNICODE(0x2665) *1%しなさいよっ%UNICODE(0x2665) *1%」	PRINTFORMW 「嗯啊%UNICODE(0x2665) *1%快点%UNICODE(0x2665) *1%做呀%UNICODE(0x2665) *1%」
PRINTFORMW 「んんっ%UNICODE(0x2665) *1%もうっ%UNICODE(0x2665) *1%じらさないでっ%UNICODE(0x2665) *1%」	PRINTFORMW 「嗯嗯啊%UNICODE(0x2665) *1%真是的%UNICODE(0x2665) *1%别弄得到处都是%UNICODE(0x2665) *1%」
PRINTFORMW 「胸は大きさじゃなくてテクニックよ？どうかしら？」	PRINTFORMW 「重要的不是大小而是技巧啊？感觉怎么样？」
PRINTFORMW 「どう？慣れたもんでしょ」	PRINTFORMW 「怎样？已经很熟练了吧」
PRINTFORMW 「こんなのでも感じるのね%UNICODE(0x2665) *1%」	PRINTFORMW 「这样的居然也有感觉了呢%UNICODE(0x2665) *1%」
PRINTFORMW 「……今メリーのおっぱいの方が気持ちよさそうって思ったでしょ」	PRINTFORMW 「……你刚刚在想梅莉的胸应该会更舒服的对吧」
PRINTFORMW 「……男って本当に胸が好きよね」	PRINTFORMW 「……男人真的很喜欢胸部呢」
PRINTFORMW 「ふぅん、こんなのがいいんだ？」	PRINTFORMW 「嗯、喜欢这种啊？」
PRINTFORMW 「どう？ドMの変態さん？」	PRINTFORMW 「怎样？抖M变态先生？」
PRINTFORMW 「ほら、さっさとくっさい精液でも射精しなさい」	PRINTFORMW 「来吧、快点吧精液射出来」
PRINTFORMW 「私に踏まれて興奮するなんて変態ね～」	PRINTFORMW 「被我踩居然这么兴奋、真是变态～」
PRINTFORMW 「男の尻の穴って面白いわね%UNICODE(0x2665) *1%」	PRINTFORMW 「男人菊穴真有趣%UNICODE(0x2665) *1%」
PRINTFORMW 「男にも子宮があるのよ？前立腺の近くにね」	PRINTFORMW 「男人也有子宫的哦？就在前列腺附近」.
PRINTFORMW 「蟻の戸渡をつぅーっとね摩るとビキビキになるのよ」	PRINTFORMW 「摩擦这附近的话会变得紧致哦」
PRINTFORMW 「んっ……男の胸板って結構好きよ」	PRINTFORMW 「嗯啊……男人的胸脯我挺喜欢的」
PRINTFORMW 「へぇ、綺麗な乳首してるのね」	PRINTFORMW 「诶、你有漂亮的乳头呢」
PRINTFORMW 「ここコリコリされるの好きなんだ？」	PRINTFORMW 「你喜欢这里被这样咯哩咯哩呀？」
PRINTFORMW 「ん～しょっぱい」	PRINTFORMW 「嗯～好咸」
PRINTFORMW 「んん……美味しくないわ」	PRINTFORMW 「嗯嗯……不好吃」
PRINTFORMW 「ん～メリーのおっぱいの方がいいわね」	PRINTFORMW 「嗯～还是梅莉的胸部更好」
PRINTFORMW 「ん～～～っ%UNICODE(0x2665) *1%」	PRINTFORMW 「嗯～～～啊%UNICODE(0x2665) *1%」
PRINTFORMW 「……んっ……ん～～っ……%UNICODE(0x2665) *1%」	PRINTFORMW 「……嗯啊……嗯～～啊……%UNICODE(0x2665) *1%」
PRINTFORMW 蓮子は%CALLNAME:MASTER%の唇とより深く交わろうとしている。	PRINTFORMW 蓮子想要与%CALLNAME:MASTER%的嘴唇更深地相交。
PRINTFORMW 「ん～～～%UNICODE(0x2665) *1%」	PRINTFORMW 「嗯～～～%UNICODE(0x2665) *1%」
PRINTFORMW 蓮子はより深くキスをしながら口腔を貪っている。	PRINTFORMW 蓮子贪求的口腔吻得更越来越深了。
PRINTFORMW 「んあっ%UNICODE(0x2665) *1%んんんっ%UNICODE(0x2665) *1%」	PRINTFORMW 「嗯啊%UNICODE(0x2665) *1%嗯嗯嗯啊%UNICODE(0x2665) *1%」
PRINTFORMW 「んっ%UNICODE(0x2665) *1%ちょっ%UNICODE(0x2665) *1%そんなに舐められたら恥ずかしいっ%UNICODE(0x2665) *1%」	PRINTFORMW 「嗯啊%UNICODE(0x2665) *1%等等%UNICODE(0x2665) *1%被这样舔、好害羞%UNICODE(0x2665) *1%」
PRINTFORMW 「んっ%UNICODE(0x2665) *1%んんんっ%UNICODE(0x2665) *1%」	PRINTFORMW 「嗯啊%UNICODE(0x2665) *1%嗯嗯嗯啊%UNICODE(0x2665) *1%」
PRINTFORMW 「あっ%UNICODE(0x2665) *1%んんっ%UNICODE(0x2665) *1%」	PRINTFORMW 「啊%UNICODE(0x2665) *1%嗯嗯啊%UNICODE(0x2665) *1%」
PRINTFORMW 蓮子は快楽に耐えかねて嬌声を上げている。	PRINTFORMW 蓮子耐不住快乐发出了娇声。
PRINTFORMW 「もうっ%UNICODE(0x2665) *1%変態っ%UNICODE(0x2665) *1%」	PRINTFORMW 「真是的%UNICODE(0x2665) *1%变态%UNICODE(0x2665) *1%」
PRINTFORMW 「んっ%UNICODE(0x2665) *1%ちょっと出ちゃいそう……っ%UNICODE(0x2665) *1%」	PRINTFORMW 「嗯啊%UNICODE(0x2665) *1%好像出来了一点……啊%UNICODE(0x2665) *1%」
PRINTFORMW 「ほら？どんなもんよ？」	PRINTFORMW 「来吧？随你喜欢？」
PRINTFORMW 「私のおっぱいの感想はどう？」	PRINTFORMW 「对我的乳房的感想怎么样？」
PRINTFORMW 「ほら、おっぱいで包んであげる%UNICODE(0x2665) *1%」	PRINTFORMW 「来吧、用胸部把你包起来%UNICODE(0x2665) *1%」
PRINTFORMW 「ああっ%UNICODE(0x2665) *1%んんっ%UNICODE(0x2665) *1%」	PRINTFORMW 「啊啊%UNICODE(0x2665) *1%嗯嗯啊%UNICODE(0x2665) *1%」
PRINTFORMW 「んっ%UNICODE(0x2665) *1%ちょっっ%UNICODE(0x2665) *1%んんっ%UNICODE(0x2665) *1%」	PRINTFORMW 「嗯啊%UNICODE(0x2665) *1%等～%UNICODE(0x2665) *1%嗯嗯啊%UNICODE(0x2665) *1%」
PRINTFORMW 「指っ%UNICODE(0x2665) *1%ダメっ%UNICODE(0x2665) *1%」	PRINTFORMW 「手指%UNICODE(0x2665) *1%不行%UNICODE(0x2665) *1%」
PRINTFORMW 「んーどう？私のおっぱいも捨てたもんじゃないでしょ%UNICODE(0x2665) *1%」	PRINTFORMW 「请吧？我的乳房也不是一般货色对吧%UNICODE(0x2665) *1%」
PRINTFORMW 「なんか安心するのよね、おっぱい吸われると」	PRINTFORMW 「总觉得很安心呢，被吸了乳房的话」
PRINTFORMW 「ほら、ママのおっぱいよ%UNICODE(0x2665) *1%」	PRINTFORMW 「来吧、妈妈的乳房哟%UNICODE(0x2665) *1%」
PRINTFORMW 「変態！痴漢！」	PRINTFORMW 「变态！痴汉！」
PRINTFORMW 蓮子はバシッと%CALLNAME:MASTER%の頬にビンタを喰らわせた	PRINTFORMW 蓮子啪的一下让%CALLNAME:MASTER%的脸吃了一巴掌
PRINTFORMW 「もうっ%UNICODE(0x2665) *1%慣れちゃったわ%UNICODE(0x2665) *1%」	PRINTFORMW 「真是的%UNICODE(0x2665) *1%我也习惯了%UNICODE(0x2665) *1%」
PRINTFORMW 「んっ%UNICODE(0x2665) *1%そんなにいやらしく触らないでよ%UNICODE(0x2665) *1%」	PRINTFORMW 「嗯啊%UNICODE(0x2665) *1%别用那么下流地方式碰我呀%UNICODE(0x2665) *1%」
PRINTFORMW 「んっ%UNICODE(0x2665) *1%こんなところで痴漢プレイなんて……%UNICODE(0x2665) *1%」	PRINTFORMW 「嗯啊%UNICODE(0x2665) *1%在这种地方玩痴汉PLAY什么的……%UNICODE(0x2665) *1%」
PRINTFORMW 「ん%UNICODE(0x2665) *1%変なことしないでよ……%UNICODE(0x2665) *1%」	PRINTFORMW 「嗯%UNICODE(0x2665) *1%不要做奇怪的事……%UNICODE(0x2665) *1%」
PRINTFORMW 「んんっ！？」	PRINTFORMW 「嗯嗯啊！？」
PRINTFORMW 「……高く付くわよ%UNICODE(0x2665) *1%」	PRINTFORMW 「……做这种事可是有代价的哟%UNICODE(0x2665) *1%」
PRINTFORMW 「……こういうの、他の場所ならしてあげるわよ」	PRINTFORMW 「……这种事、如果是别的地方的话我会给你做的」
PRINTFORMW 蓮子は少し困ったように人気のないところに誘ってきた。	PRINTFORMW 蓮子有些困扰的邀请我去人少的地方。
PRINTFORMW 「……バレてるわよ」	PRINTFORMW 「……暴露了哦」
PRINTFORMW 「人身事故に遭いたくないならやめなさい？」	PRINTFORMW 「你不想受伤就快停手吧？」
PRINTFORMW 「……痴漢なんてするもんじゃないわ」	PRINTFORMW 「……痴汉行为是不能做的」
PRINTFORMW 「頭の中まで金玉が詰まってるのかしら？」	PRINTFORMW 「你脑子里都塞满了睾丸吗？」
PRINTFORMW 「人の尻をいやらしく触るなんて……！」	PRINTFORMW 「下流地摸别人的屁股……！」
PRINTFORMW 「全くあきれたもんだわ」	PRINTFORMW 「真是令人作呕」
PRINTFORMW 蓮子は自分の尻を蹂躙する%CALLNAME:MASTER%の手を振り払った。	PRINTFORMW 蓮子把蹂躏自己屁股的%CALLNAME:MASTER%的手甩开了。
PRINTFORMW 「……ん……メリー……？」	PRINTFORMW 「……嗯……梅莉……？」
PRINTFORMW 蓮子は誰かと勘違いしながら%CALLNAME:MASTER%の体温を感じている。	PRINTFORMW 蓮子一边误会是别人一边感受着%CALLNAME:MASTER%的体温。
PRINTFORMW 「ふふっ……もっと密着していいのに%UNICODE(0x2665) *1%」	PRINTFORMW 「呼呼～……明明再贴紧一些也可以的%UNICODE(0x2665) *1%」
PRINTFORMW 「んーこうするの、好きなのよ%UNICODE(0x2665) *1%」	PRINTFORMW 「嗯～这样做、喜欢的哟%UNICODE(0x2665) *1%」
PRINTFORMW 蓮子は%CALLNAME:MASTER%を抱き返してきた。	PRINTFORMW 蓮子向着%CALLNAME:MASTER%抱了回去。
PRINTFORMW 「抱きつかれると好きになっちゃうじゃない、%CALLNAME:MASTER%」	PRINTFORMW 「被你这样抱着的话不就会喜欢上你了吗、%CALLNAME:MASTER%」
PRINTFORMW 蓮子は%CALLNAME:MASTER%に抱きつかれると小声でそういった。	PRINTFORMW 蓮子被%CALLNAME:MASTER%抱住后小声的说着。
PRINTFORMW 「うん、こうしているとお互いの体温が移っていくのが分かるわね」	PRINTFORMW 「嗯、你知道吗？这样做的话、彼此的体温就会互相转移」
PRINTFORMW 「んん？どうしたのよ？甘えたいの？」	PRINTFORMW 「嗯嗯？怎么了？想撒娇吗？」
PRINTFORMW 「あーもう……！ひっついてもいいけど離れてよね！？」	PRINTFORMW 「啊真是的……！粘着我倒是没什么、但请稍微分开点！？」
PRINTFORMW 「何よ……急に抱きつかないでって言ってるでしょ？」	PRINTFORMW 「什么……我不是说过不要突然抱住我吗？」
PRINTFORMW 蓮子はそう言いながらも%CALLNAME:MASTER%を愛おしそうに抱きとめた。	PRINTFORMW 蓮子嘴上这么说着但还是充满爱意地抱住了%CALLNAME:MASTER%。
PRINTFORMW 「もう、メリーじゃ無いんだから……」	PRINTFORMW 「真是的、你又不是梅莉……」
PRINTFORMW 「……汗臭い」	PRINTFORMW 「……汗臭味」
PRINTFORMW 「はいはい、よしよしすればいいの？」	PRINTFORMW 「好啦好啦、摸摸你的头就行了吧？」
PRINTFORMW 「ちょっとやめてよ」	PRINTFORMW 「别这样」
PRINTFORMW 「……趣味じゃないわ、離れてよ」	PRINTFORMW 「……我没这个兴趣、放开我」
PRINTFORMW 「……臭い」	PRINTFORMW 「……好臭」
PRINTFORMW 凍てついた時の中で蓮子の唇を奪った。	PRINTFORMW 在冻结的时间中夺走了蓮子的嘴唇。
PRINTFORMW その唇は柔らかく、甘酢っぱい味がした。	PRINTFORMW 那柔软的嘴唇、有股酸酸甜甜的味道。
PRINTFORMW 「……ん～っ」	PRINTFORMW 「……嗯～啊」
PRINTFORMW 蓮子はキスをされると少しくぐもった声を出した。	PRINTFORMW 蓮子被亲吻的时候发出了苦闷的声音。
PRINTFORMW 「んんっ……%UNICODE(0x2665) *1%ダメよ、キスなんて……%UNICODE(0x2665) *1%」	PRINTFORMW 「嗯嗯啊……%UNICODE(0x2665) *1%不行啊、接吻什么的……%UNICODE(0x2665) *1%」
PRINTFORMW 蓮子はそう言いながらも%CALLNAME:MASTER%の唇を奪い返した。	PRINTFORMW 蓮子一边这样说着一边反过来夺去了%CALLNAME:MASTER%的嘴唇。
PRINTFORMW 蓮子は唇を奪われたままなすがままになっている。	PRINTFORMW 蓮子保持着嘴唇被夺走的状态。
PRINTFORMW 「んっ……！？」	PRINTFORMW 「嗯啊……！？」
PRINTFORMW 「急にするから緊張するじゃない……%UNICODE(0x2665) *1%」	PRINTFORMW 「突然这么做害的我都紧张起来了……%UNICODE(0x2665) *1%」
PRINTFORMW 「んっ%UNICODE(0x2665) *1%」	PRINTFORMW 「嗯啊%UNICODE(0x2665) *1%」
PRINTFORMW 「こういうの、結構好きよ%UNICODE(0x2665) *1%」	PRINTFORMW 「这样做、我挺喜欢的哦%UNICODE(0x2665) *1%」
PRINTFORMW 「んんっ%UNICODE(0x2665) *1%んっ～～～%UNICODE(0x2665) *1%」	PRINTFORMW 「嗯嗯啊%UNICODE(0x2665) *1%嗯啊～～～%UNICODE(0x2665) *1%」
PRINTFORMW 蓮子はキスをされるとさらに唇を押し付けてきた。	PRINTFORMW 蓮子在亲吻结束之后又把嘴唇凑了过来。
PRINTFORMW 「んっ%UNICODE(0x2665) *1%……いきなりされたら困るわよ」	PRINTFORMW 「嗯啊%UNICODE(0x2665) *1%……突然这么做我会困扰哦」
PRINTFORMW 「んん……%UNICODE(0x2665) *1%」	PRINTFORMW 「嗯嗯……%UNICODE(0x2665) *1%」
PRINTFORMW 「……もう終わり？」	PRINTFORMW 「……已经结束了？」
PRINTFORMW 「……これだけ？」	PRINTFORMW 「……就这样？」
PRINTFORMW 「んんん！？」	PRINTFORMW 「嗯嗯嗯！？」
PRINTFORMW 蓮子は%CALLNAME:MASTER%に唇を奪われて困惑している。	PRINTFORMW 蓮子对被%CALLNAME:MASTER%夺走嘴唇感到困惑。
PRINTFORMW 「……ん！」	PRINTFORMW 「……嗯！」
PRINTFORMW 「……馬鹿……！」	PRINTFORMW 「……笨蛋……！」
PRINTFORMW 「んっ……気持ち悪い……」	PRINTFORMW 「嗯啊……真恶心……」
PRINTFORMW 蓮子は唇をぬぐいながら弱々しく睨みつけている。	PRINTFORMW 蓮子擦着嘴唇轻轻地瞪着这边。
PRINTFORMW 凍てついた時の中で蓮子の標準的な胸を愛撫した。	PRINTFORMW 在冻结的时间中爱抚着蓮子标准大小的胸部。
PRINTFORMW 「……何よ……んんっ……」	PRINTFORMW 「……什么……嗯嗯啊……」
PRINTFORMW 蓮子は標準的な胸を愛撫されると少しくぐもった声を出した。	PRINTFORMW 蓮子在被爱抚着那标准大小的胸部时发出了一些苦闷的声音。
PRINTFORMW 「んっ……%UNICODE(0x2665) *1%もう胸ばかり虐めないでよ馬鹿っ%UNICODE(0x2665) *1%」	PRINTFORMW 「嗯啊……%UNICODE(0x2665) *1%不要老是欺负我的胸部呀笨蛋%UNICODE(0x2665) *1%」
PRINTFORMW 「んっ……あまり虐めないでよ……%UNICODE(0x2665) *1%」	PRINTFORMW 「嗯啊……不要太欺负我呀……%UNICODE(0x2665) *1%」
PRINTFORMW 蓮子はそう言いながら体を震わせている。	PRINTFORMW 蓮子一边说一边颤抖着。
PRINTFORMW 「……メリーみたいなサイズにしてくれるのかしら%UNICODE(0x2665) *1%」	PRINTFORMW 「……这样能让我变的和梅莉一样大吗%UNICODE(0x2665) *1%」
PRINTFORMW 「んっ！？」	PRINTFORMW 「嗯啊！？」
PRINTFORMW 「ちょっとそんなに揉まないでよ……敏感なんだから……%UNICODE(0x2665) *1%」	PRINTFORMW 「等下别这么揉嘛……很敏感的……%UNICODE(0x2665) *1%」
PRINTFORMW 「こんなサイズでも揉むのには不自由しないのよね？」	PRINTFORMW 「即使是我这样的尺寸揉起来也不会不方便吧？」
PRINTFORMW 「%CALLNAME:MASTER%に揉まれるのならいいわよ……%UNICODE(0x2665) *1%」	PRINTFORMW 「%CALLNAME:MASTER%想揉的话、可以哦……%UNICODE(0x2665) *1%」
PRINTFORMW 蓮子は顔を赤らめながら胸を愛撫されている。	PRINTFORMW 蓮子红着脸被爱抚着胸部。
PRINTFORMW 「んっ%UNICODE(0x2665) *1%ちょっとっ……んっ%UNICODE(0x2665) *1%」	PRINTFORMW 「嗯啊%UNICODE(0x2665) *1%等等……嗯啊%UNICODE(0x2665) *1%」
PRINTFORMW 「……感じてなんかないわよ」	PRINTFORMW 「……感觉什么的没有哦」
PRINTFORMW 「……揉むならメリーのにしてよ……」	PRINTFORMW 「……要揉的话就去找梅莉呀……」
PRINTFORMW 「男ってこれだから……！」	PRINTFORMW 「所以说男人真是的……！」
PRINTFORMW 「最近の痴漢は大胆なのね、死ねばいいのに」	PRINTFORMW 「最近的痴汉好大胆啊、怎么不去死」
PRINTFORMW 蓮子は%CALLNAME:MASTER%に胸を触れられて困惑している。	PRINTFORMW 蓮子对自己的胸部被%CALLNAME:MASTER%触摸感到困惑。
PRINTFORMW 「何？嫌がらせ？」	PRINTFORMW 「什么？性骚扰？」
PRINTFORMW 「……最っ低っ！」	PRINTFORMW 「……真差劲！」
PRINTFORMW 凍てついた時の中で蓮子のアナルを愛撫した。	PRINTFORMW 在冻结的时间中爱抚着蓮子的肛門。
PRINTFORMW 「……ん……？」	PRINTFORMW 「……嗯……？」
PRINTFORMW 蓮子はアナルを愛撫されると少しくぐもった声を出した。	PRINTFORMW 蓮子在被爱抚着肛门时发出了一些苦闷的声音。
PRINTFORMW 「んっ%UNICODE(0x2665) *1%ちょっとっ%UNICODE(0x2665) *1%」	PRINTFORMW 「嗯啊%UNICODE(0x2665) *1%等等%UNICODE(0x2665) *1%」
PRINTFORMW 「待って……準備とかあるから……%UNICODE(0x2665) *1%」	PRINTFORMW 「等一下……还没做好准备……%UNICODE(0x2665) *1%」
PRINTFORMW 「んっ……何でもないわよ%UNICODE(0x2665) *1%」	PRINTFORMW	「嗯啊……什么都没有%UNICODE(0x2665) *1%」
PRINTFORMW 「あっ%UNICODE(0x2665) *1%……っ%UNICODE(0x2665) *1%」	PRINTFORMW 「啊%UNICODE(0x2665) *1%……啊%UNICODE(0x2665) *1%」
PRINTFORMW 「……ちょっとっ%UNICODE(0x2665) *1%」	PRINTFORMW	「……等下%UNICODE(0x2665) *1%」
PRINTFORMW 「そんなとこ穿らないでよ……%UNICODE(0x2665) *1%」	PRINTFORMW 「不要碰那种地方啊……%UNICODE(0x2665) *1%」
PRINTFORMW 「……んんっ%UNICODE(0x2665) *1%」	PRINTFORMW 「……嗯嗯啊%UNICODE(0x2665) *1%」
PRINTFORMW 蓮子は顔を赤らめながらアナルを愛撫されている。	PRINTFORMW 蓮子红着脸被爱抚着肛门。
PRINTFORMW 「ちょっとっ！……どこ触ってるのよ……」	PRINTFORMW 「等等！……在摸哪里啊……」
PRINTFORMW 「……男って最低よね、そんなにお尻が好きかしら？」	PRINTFORMW 「……男人真是差劲、就那么喜欢屁股吗？」
PRINTFORMW 「んっ……%UNICODE(0x2665) *1%」	PRINTFORMW 「嗯啊……%UNICODE(0x2665) *1%」
PRINTFORMW 「……それで私が興奮するとでも思ってるわけ？」	PRINTFORMW 「……所以你难道以为我会兴奋吗？」
PRINTFORMW 「……どこ触ってんのよ！」	PRINTFORMW 「……在摸哪里啊！」
PRINTFORMW 蓮子は%CALLNAME:MASTER%にアナルに触れられて困惑している。	PRINTFORMW 蓮子对自己的肛门被%CALLNAME:MASTER%触摸感到困惑。
PRINTFORMW 「やめなさい！」	PRINTFORMW 「停下来！」
PRINTFORMW 「こんなことしてただで済むと思ってるんじゃないわよね？」	PRINTFORMW 「你不会以为做了这种事我会原谅你吧？」
PRINTFORMW 「んんんっ%UNICODE(0x2665) *1%もっと挿入れてっ%UNICODE(0x2665) *1%」	PRINTFORMW 「嗯嗯啊%UNICODE(0x2665) *1%再插深一点%UNICODE(0x2665) *1%」
PRINTFORMW 「んんんっ%UNICODE(0x2665) *1%馬鹿になっちゃうううう%UNICODE(0x2665) *1%%UNICODE(0x2665) *1%%UNICODE(0x2665) *1%」	PRINTFORMW 「嗯嗯嗯啊%UNICODE(0x2665) *1%要变成笨蛋啦～～%UNICODE(0x2665) *1%%UNICODE(0x2665) *1%%UNICODE(0x2665) *1%」
PRINTFORMW 「ああっ%UNICODE(0x2665) *1%これすごくいいっ%UNICODE(0x2665) *1%」	PRINTFORMW 「啊啊%UNICODE(0x2665) *1%这个感觉很好%UNICODE(0x2665) *1%」
PRINTFORMW 「これなら挿入れやすいでしょ……%UNICODE(0x2665) *1%」	PRINTFORMW 「这样的话很容易插入吧……%UNICODE(0x2665) *1%」
PRINTFORMW 「今っ、滅茶苦茶にされたいの……%UNICODE(0x2665) *1%」	PRINTFORMW 「现在、想被搞得乱七八糟……%UNICODE(0x2665) *1%」
PRINTFORMW 「私……マゾじゃ無いのに……%UNICODE(0x2665) *1%」	PRINTFORMW 「我……明明不是M的……%UNICODE(0x2665) *1%」
PRINTFORMW 凍てついた時の中で蓮子のスカートをめくった。	PRINTFORMW 在冻结的时间中掀起了蓮子的裙子。
PRINTFORMW %CALLNAME:MASTER%は蓮子のスタイルのいい尻を眺めて楽しんだ。	PRINTFORMW %CALLNAME:MASTER%高兴的看着蓮子那外形良好的屁股。
PRINTFORMW 「へぇ？こういうプレイがいいんだ%UNICODE(0x2665) *1%」	PRINTFORMW 「诶？这种PLAY也挺好的%UNICODE(0x2665) *1%」
PRINTFORMW 「馬鹿！何するのよ！」	PRINTFORMW 「笨蛋！干什么啊！」
PRINTFORMW 蓮子はキッと睨み付けながらスカートを抑えている。	PRINTFORMW 蓮子一边盯着这边一边按住裙子。
PRINTFORMW 「ん？」	PRINTFORMW 「嗯？」
PRINTFORMW 蓮子はスカートを捲り上げられながら恥ずかしそうに顔を赤らめている。	PRINTFORMW 害羞的蓮子脸红着的把裙子掀了起来。
PRINTFORMW 「そんなに見たいのなら言えばいいのに……%UNICODE(0x2665) *1%」	PRINTFORMW 「如果你那么想看的话、和我说就好了……%UNICODE(0x2665) *1%」
PRINTFORMW 「男子ってこういうの好きよね%UNICODE(0x2665) *1%」	PRINTFORMW 「男生就喜欢这样对吧%UNICODE(0x2665) *1%」
PRINTFORMW 「こうした方がいい？」	PRINTFORMW 「这样比较好？」
PRINTFORMW 蓮子はスカートを捲りあげられるとそのまま端を持ち上げて中を見せつけてきた。	PRINTFORMW 蓮子把裙子卷了起来、就这样抓着裙子的一角朝这边看了过来。
PRINTFORMW 「気に入ったかしら？変態さん%UNICODE(0x2665) *1%」	PRINTFORMW 「你喜欢吗？变态先生%UNICODE(0x2665) *1%」
PRINTFORMW 「……気持ち悪い……%UNICODE(0x2665) *1%」	PRINTFORMW 「……真恶心……%UNICODE(0x2665) *1%」
PRINTFORMW 蓮子はそう言っておずおずとスカートの端を捲り上げている。	PRINTFORMW 蓮子这样说着怯生生的把裙子的边卷了起来。
PRINTFORMW 「男っていつまで経っても子供よねぇ……こんなので興奮するなんてね」	PRINTFORMW 「男人无论过多久都是孩子啊……这样居然就能兴奋起来」
PRINTFORMW 「人のスカートを捲る趣味は褒められないわねぇ……%UNICODE(0x2665) *1%」	PRINTFORMW 「卷起别人裙子的兴趣真是无法表扬……%UNICODE(0x2665) *1%」
PRINTFORMW 「ちょっと止めてよ！」	PRINTFORMW 「等下快停下！」
PRINTFORMW 蓮子は呆れた様子でスカートを捲られている。	PRINTFORMW 蓮子目瞪口呆地被卷起了裙子。
PRINTFORMW 「私の結界を暴きたいってわけ？……馬鹿の考えそうな事ね」	PRINTFORMW 「你想揭开我的结界？……真是傻瓜会有想法」
PRINTFORMW 「これだから男は……」	PRINTFORMW 「所以说男人真是的……」
PRINTFORMW 「……頭の中にも精子が詰まっているのかしら？」	PRINTFORMW 「……脑子里也塞满了精子吗？」
PRINTFORMW 「変っ態っ！」	PRINTFORMW 「变！态！」
PRINTFORMW 「何考えてそういうことをしたのか貴重な脳みそを使って一応考えてあげるわ」	PRINTFORMW 「我会用我宝贵的大脑来想想你是到底怎么想的」
PRINTFORMW 「んんっ%UNICODE(0x2665) *1%優しくしてよねっ%UNICODE(0x2665) *1%」	PRINTFORMW 「啊啊嗯%UNICODE(0x2665) *1%要温柔一点哦%UNICODE(0x2665) *1%」
PRINTFORMW 「んっ%UNICODE(0x2665) *1%んひっ%UNICODE(0x2665) *1%」	PRINTFORMW 「嗯啊%UNICODE(0x2665) *1%咿呀%UNICODE(0x2665) *1%」
PRINTFORMW 「んっ%UNICODE(0x2665) *1%もっとっ%UNICODE(0x2665) *1%感じさせてっ%UNICODE(0x2665) *1%」	PRINTFORMW 「嗯啊%UNICODE(0x2665) *1%更多更多%UNICODE(0x2665) *1%让我感受更多%UNICODE(0x2665) *1%」
PRINTFORMW 「あっ%UNICODE(0x2665) *1%もうっ%UNICODE(0x2665) *1%ちょっとっ%UNICODE(0x2665) *1%」	PRINTFORMW 「啊%UNICODE(0x2665) *1%真是的%UNICODE(0x2665) *1%等等%UNICODE(0x2665) *1%」
PRINTFORMW 「んっ%UNICODE(0x2665) *1%そこっ%UNICODE(0x2665) *1%敏感だからっ%UNICODE(0x2665) *1%」	PRINTFORMW 「嗯啊%UNICODE(0x2665) *1%那里%UNICODE(0x2665) *1%很敏感%UNICODE(0x2665) *1%」
PRINTFORMW 「んっ%UNICODE(0x2665) *1%ちょっ%UNICODE(0x2665) *1%そんなに舐められたら恥ずかしいっ%UNICODE(0x2665) *1%」	PRINTFORMW 「嗯啊%UNICODE(0x2665) *1%等等%UNICODE(0x2665) *1%那样被舔的话好害羞%UNICODE(0x2665) *1%」
PRINTFORMW 「あっ%UNICODE(0x2665) *1%待ってっ%UNICODE(0x2665) *1%」	PRINTFORMW 「啊%UNICODE(0x2665) *1%等一下%UNICODE(0x2665) *1%」
PRINTFORMW 「んっ%UNICODE(0x2665) *1%これ太っ%UNICODE(0x2665) *1%」	PRINTFORMW 「嗯啊%UNICODE(0x2665) *1%这个好粗%UNICODE(0x2665) *1%」
PRINTFORMW 「ちょっ%UNICODE(0x2665) *1%指はダメぇっ%UNICODE(0x2665) *1%」	PRINTFORMW 「等%UNICODE(0x2665) *1%手指不行%UNICODE(0x2665) *1%」
PRINTFORMW 「んっ%UNICODE(0x2665) *1%ちょっとっ%UNICODE(0x2665) *1%そんなガシガシされたらっ%UNICODE(0x2665) *1%」	PRINTFORMW 「嗯啊%UNICODE(0x2665) *1%等等%UNICODE(0x2665) *1%被那样摸的话%UNICODE(0x2665) *1%」
PRINTFORMW 「お尻舐めたいなんて……変態ね」	PRINTFORMW 「想舔屁股什么的……真是变态」
PRINTFORMW 「……まるで垢舐めね」	PRINTFORMW 「……简直就像在舔污垢一样」
PRINTFORMW 「んっ……変態」	PRINTFORMW 「嗯啊……变态」
PRINTFORMW 「んっ……ばかっ……%UNICODE(0x2665) *1%」	PRINTFORMW 「嗯啊……笨蛋……%UNICODE(0x2665) *1%」
PRINTFORMW 「ちょっとっ……どこ触ってんのよっ%UNICODE(0x2665) *1%」	PRINTFORMW 「等下……你在摸哪里啊%UNICODE(0x2665) *1%」
PRINTFORMW 「っ……んっ……%UNICODE(0x2665) *1%」	PRINTFORMW 「啊……嗯啊……%UNICODE(0x2665) *1%」
PRINTFORMW 「んん……変態……%UNICODE(0x2665) *1%」	PRINTFORMW 「嗯嗯……变态……%UNICODE(0x2665) *1%」
PRINTFORMW 「んんっ%UNICODE(0x2665) *1%……そりゃ綺麗にしてるけど……」	PRINTFORMW 「嗯嗯啊%UNICODE(0x2665) *1%……虽然已经洗过了……」
PRINTFORMW 「……んんっ%UNICODE(0x2665) *1%……優しくね%UNICODE(0x2665) *1%」	PRINTFORMW 「……嗯嗯啊%UNICODE(0x2665) *1%……好温柔啊%UNICODE(0x2665) *1%」
PRINTFORMW 「んんっ%UNICODE(0x2665) *1%敏感なんだから優しく……んっ%UNICODE(0x2665) *1%」	PRINTFORMW 「嗯嗯啊%UNICODE(0x2665) *1%很敏感的所以温柔一……嗯啊%UNICODE(0x2665) *1%」
PRINTFORMW 「あっ%UNICODE(0x2665) *1%変な声出ちゃうっ%UNICODE(0x2665) *1%」	PRINTFORMW 「啊%UNICODE(0x2665) *1%要发出奇怪的声音了%UNICODE(0x2665) *1%」
PRINTFORMW 「んんっ%UNICODE(0x2665) *1%ちょっと待ってっ%UNICODE(0x2665) *1%敏感だからっ%UNICODE(0x2665) *1%」	PRINTFORMW 「嗯嗯啊%UNICODE(0x2665) *1%稍等一下%UNICODE(0x2665) *1%那里很敏感%UNICODE(0x2665) *1%」
PRINTFORMW 「あっ%UNICODE(0x2665) *1%……変な声出ちゃった」	PRINTFORMW 「啊%UNICODE(0x2665) *1%……要发出奇怪的声音了」
PRINTFORMW 「んーメリーよりは小さいけど私の胸もなかなかの物じゃない？」	PRINTFORMW 「嗯虽然我的胸比梅莉要小、但也很不错吧？」
PRINTFORMW 「んんっ%UNICODE(0x2665) *1%んっ%UNICODE(0x2665) *1%」	PRINTFORMW 「嗯嗯啊%UNICODE(0x2665) *1%嗯啊%UNICODE(0x2665) *1%」
PRINTFORMW 「んっ%UNICODE(0x2665) *1%そこ敏感だからっ%UNICODE(0x2665) *1%」	PRINTFORMW 「嗯啊%UNICODE(0x2665) *1%那里很敏感的%UNICODE(0x2665) *1%」
PRINTFORMW 「んっ%UNICODE(0x2665) *1%ちょっとっ%UNICODE(0x2665) *1%いい加減にっ%UNICODE(0x2665) *1%」	PRINTFORMW 「嗯啊%UNICODE(0x2665) *1%等下%UNICODE(0x2665) *1%适可而止啊%UNICODE(0x2665) *1%」
PRINTFORMW 「んっ%UNICODE(0x2665) *1%乳首ばかりっ%UNICODE(0x2665) *1%」	PRINTFORMW 「嗯啊%UNICODE(0x2665) *1%一直玩弄乳头%UNICODE(0x2665) *1%」
PRINTFORMW 「あっ%UNICODE(0x2665) *1%んあっ%UNICODE(0x2665) *1%」	PRINTFORMW 「啊%UNICODE(0x2665) *1%嗯啊%UNICODE(0x2665) *1%」
PRINTFORMW 「あんっ%UNICODE(0x2665) *1%そこっ%UNICODE(0x2665) *1%」	PRINTFORMW 「啊恩%UNICODE(0x2665) *1%那里%UNICODE(0x2665) *1%」
PRINTFORMW 「こうした方が興奮するのかしら？」	PRINTFORMW 「这样做会让你更兴奋吗？」
PRINTFORMW 「疼くのよ……言わせないで%UNICODE(0x2665) *1%」	PRINTFORMW 「下面好疼……不要让我来说啊%UNICODE(0x2665) *1%」
PRINTFORMW 「早く挿入れて……%UNICODE(0x2665) *1%」	PRINTFORMW 「快点插进来……%UNICODE(0x2665) *1%」
PRINTFORMW 「こっちには挿入れてくれないの……%UNICODE(0x2665) *1%」	PRINTFORMW 「能不能插进来呢……%UNICODE(0x2665) *1%」
PRINTFORMW 「自分で広げろって……変態……」	PRINTFORMW 「竟然要我自己张开……变态……」
PRINTFORMW 「そんなに見たいの……？」	PRINTFORMW 「这么想看吗……？」
PRINTFORMW 「……恥ずかしいわ」	PRINTFORMW 「……真让人害羞」
PRINTFORMW 「ん……見てていいわよ……%UNICODE(0x2665) *1%」	PRINTFORMW 「嗯……你可以看哦……%UNICODE(0x2665) *1%」
PRINTFORMW 「んんっ%UNICODE(0x2665) *1%%CALLNAME:MASTER%……%UNICODE(0x2665) *1%」	PRINTFORMW 「嗯嗯啊%UNICODE(0x2665) *1%%CALLNAME:MASTER%……%UNICODE(0x2665) *1%」
PRINTFORMW 「んっ%UNICODE(0x2665) *1%%CALLNAME:MASTER%っ%UNICODE(0x2665) *1%」	PRINTFORMW 「嗯啊%UNICODE(0x2665) *1%%CALLNAME:MASTER%啊%UNICODE(0x2665) *1%」
PRINTFORMW 「っ%UNICODE(0x2665) *1%%CALLNAME:MASTER%っ%UNICODE(0x2665) *1%」	PRINTFORMW 「啊%UNICODE(0x2665) *1%%CALLNAME:MASTER%啊%UNICODE(0x2665) *1%」
PRINTFORMW 「ん……あんまり見ないでよ……んっ……%UNICODE(0x2665) *1%」	PRINTFORMW 「嗯……不要一直盯着我啊……嗯啊……%UNICODE(0x2665) *1%」
PRINTFORMW 「んっ%UNICODE(0x2665) *1%……メリーっ%UNICODE(0x2665) *1%」	PRINTFORMW 「嗯啊%UNICODE(0x2665) *1%……梅莉啊%UNICODE(0x2665) *1%」
PRINTFORMW 「ん……あっ……変態……%UNICODE(0x2665) *1%」	PRINTFORMW 「嗯……啊……变态……%UNICODE(0x2665) *1%」
PRINTFORMW 「んっ……そんなに吸わないでよ」	PRINTFORMW 「嗯啊……不要这样吸呀」
PRINTFORMW 「ちょっと……待ってっ%UNICODE(0x2665) *1%」	PRINTFORMW 「等下……等下啊%UNICODE(0x2665) *1%」
PRINTFORMW 「んんっ……%UNICODE(0x2665) *1%そんなに美味しい？」	PRINTFORMW 「嗯嗯啊……%UNICODE(0x2665) *1%有那么美味？」
PRINTFORMW 「んんっ……乳首伸びちゃう……%UNICODE(0x2665) *1%」	PRINTFORMW 「嗯嗯啊……乳头被拉长了……%UNICODE(0x2665) *1%」
PRINTFORMW 「……今メリーのおっぱいのこと考えてたでしょ？」	PRINTFORMW 「……你刚刚在想梅莉的胸部对吧？」
PRINTFORMW 「そんなに揉んだら大きくなるじゃない……%UNICODE(0x2665) *1%」	PRINTFORMW 「这样揉的话就能变大了吧……%UNICODE(0x2665) *1%」
PRINTFORMW 「んっ%UNICODE(0x2665) *1%あんっ%UNICODE(0x2665) *1%」	PRINTFORMW 「嗯啊%UNICODE(0x2665) *1%啊恩%UNICODE(0x2665) *1%」
PRINTFORMW 「んっ……%UNICODE(0x2665) *1%私のおっぱい揉んで興奮してるんだ……スケベ%UNICODE(0x2665) *1%」	PRINTFORMW 「嗯啊……%UNICODE(0x2665) *1%揉着我的胸部兴奋起来了啊……色鬼%UNICODE(0x2665) *1%」
PRINTFORMW 「恥ずかしいから……早くしなさいよ%UNICODE(0x2665) *1%」	PRINTFORMW 「因为很害羞……所以快点结束啊%UNICODE(0x2665) *1%」
PRINTFORMW 「こっちには挿入れてくれないんだ%UNICODE(0x2665) *1%」	PRINTFORMW 「这里是不该用来插入的%UNICODE(0x2665) *1%」
PRINTFORMW 「こっちも犯してくれないと満足できないわ%UNICODE(0x2665) *1%」	PRINTFORMW 「你不来侵犯我我是不会满足的啊%UNICODE(0x2665) *1%」
PRINTFORMW 「こっちが足りないわ%UNICODE(0x2665) *1%」	PRINTFORMW 「这边还不够%UNICODE(0x2665) *1%」
PRINTFORMW 「こっちには挿入れてくれないの%UNICODE(0x2665) *1%」	PRINTFORMW 「能不能插进来呢%UNICODE(0x2665) *1%」
PRINTFORMW 「恥ずかしいことさせないでよ……%UNICODE(0x2665) *1%」	PRINTFORMW 「不要让我做这么害羞的事情啊……%UNICODE(0x2665) *1%」
PRINTFORMW 「あんまり見ないでよね」	PRINTFORMW 「不要一直的盯着啊」
PRINTFORMW 「んっ……！」	PRINTFORMW 「嗯啊……！」
PRINTFORMW 「……好きよ、%CALLNAME:MASTER%、%UNICODE(0x2665) *1%」	PRINTFORMW 「……喜欢、%CALLNAME:MASTER%、%UNICODE(0x2665) *1%」
PRINTFORMW 「んっ%UNICODE(0x2665) *1%っ……%UNICODE(0x2665) *1%」	PRINTFORMW 「嗯啊%UNICODE(0x2665) *1%啊……%UNICODE(0x2665) *1%」
PRINTFORMW 「このまま……%UNICODE(0x2665) *1%」	PRINTFORMW 「就这样……%UNICODE(0x2665) *1%」
PRINTFORMW 「んんっ%UNICODE(0x2665) *1%んん～っ%UNICODE(0x2665) *1%」	PRINTFORMW 「嗯嗯啊%UNICODE(0x2665) *1%嗯嗯～啊%UNICODE(0x2665) *1%」
PRINTFORMW 「ちょっと休憩？いいわよ」	PRINTFORMW 「要稍微休息一下？好啊」
PRINTFORMW 「なんだか逆に興奮してきたわね……%UNICODE(0x2665) *1%」	PRINTFORMW 「总觉得这样反而兴奋起来了呢……%UNICODE(0x2665) *1%」
PRINTFORMW 「続きはまだなの%UNICODE(0x2665) *1%」	PRINTFORMW 「还不继续吗%UNICODE(0x2665) *1%」
PRINTFORMW 「……このままでもいいわよ？」	PRINTFORMW 「……就这样下去也可以吗？」
PRINTFORMW 「こうしてるとセックスってのも悪くないわね」	PRINTFORMW 「这样说的话做爱也不错呢」
PRINTFORMW 「……もうちょっと面白い話を仕入れときなさいよ、馬鹿」	PRINTFORMW 「……找点有趣的话题再来啊、笨蛋」
PRINTFORMW 「へぇ、ムード作ってくれるのね？」	PRINTFORMW 「诶、在给我制造气氛吗？」
PRINTFORMW 「……セックスって体力使うのよね」	PRINTFORMW 「……做爱真是费体力呢」
PRINTFORMW 「……少し休憩しよっか」	PRINTFORMW 「……稍微休息一下吧」
PRINTFORMW 「こんなの握らせないでよ……」	PRINTFORMW 「不要让我握住这样的东西啊……」
PRINTFORMW 「なんでこんなところに来てまで男のチンポ舐めないといけないのかしら……」	PRINTFORMW 「为什么到了这种地方还得舔男人的鸡巴啊……」
PRINTFORMW 「こんなのメリーにしてもらえばいいじゃない……」	PRINTFORMW 「这种事让梅莉做不就好了吗……」
PRINTFORMW 「んんっ%UNICODE(0x2665) *1%これっ擦れて……%UNICODE(0x2665) *1%」	PRINTFORMW 「嗯嗯啊%UNICODE(0x2665) *1%这样摩擦……%UNICODE(0x2665) *1%」
PRINTFORMW 「本当に風呂屋ねこれじゃ」	PRINTFORMW 「这样不就成了搓澡工了吗」
PRINTFORMW 「ん……どう？気持ちいい？」	PRINTFORMW 「嗯……怎样？舒服吗？」
PRINTFORMW 「んー？痒いところはない？」	PRINTFORMW 「嗯ー？有没有痒的地方？」
PRINTFORMW 「ほら、体くっつけないと洗えないでしょ？」	PRINTFORMW 「看吧、不贴在一起就洗不干净吧？」
PRINTFORMW 「足で踏まれて興奮するなんてやっぱり男って最低ね」	PRINTFORMW 「被用脚踩着反而感到兴奋、果然男人最差劲了」
PRINTFORMW 「んんん～～～」	PRINTFORMW 「嗯嗯嗯～～～」
PRINTFORMW 蓮子は勢いよく陰茎にむしゃぶりついている。	PRINTFORMW 蓮子气势汹汹地榨着阴茎。
PRINTFORMW 「ん……とんでもなく臭いわ」	PRINTFORMW 「嗯……非常的臭啊」
PRINTFORMW 「ん……変な味ね」	PRINTFORMW 「嗯……奇怪的味道」
PRINTFORMW 「ん……んんっ……」	PRINTFORMW 「嗯……嗯嗯啊……」
PRINTFORMW 「んん……変な臭い」	PRINTFORMW 「嗯嗯……奇怪的气味」
PRINTFORMW 凍てついた時の中で蓮子は絶頂した。	PRINTFORMW 在冻结的时间中蓮子迎来了高潮。
PRINTFORMW 「……おっぱいで感じるのね……私」	PRINTFORMW 「……胸部有感觉了呢……我」
PRINTFORMW 「おﾞっ%UNICODE(0x2665) *1%おﾞおﾞっ%UNICODE(0x2665) *1%んんﾞっ%UNICODE(0x2665) *1%」	PRINTFORMW 「哦%UNICODE(0x2665) *1%呜呜啊%UNICODE(0x2665) *1%嗯嗯啊%UNICODE(0x2665) *1%」
PRINTFORMW 蓮子は声にならない嬌声を上げながら途轍もない快楽に身を震わせている。	PRINTFORMW 蓮子发出了几乎无法听到声音的娇声、全身被无比的快乐所震撼。
PRINTFORMW 「おﾞっ%UNICODE(0x2665) *1%んんんっ%UNICODE(0x2665) *1%」	PRINTFORMW 「呜%UNICODE(0x2665) *1%嗯嗯嗯啊%UNICODE(0x2665) *1%」
PRINTFORMW 「おﾞっ%UNICODE(0x2665) *1%んんっ%UNICODE(0x2665) *1%んんんっ%UNICODE(0x2665) *1%」	PRINTFORMW 「呜%UNICODE(0x2665) *1%嗯嗯啊%UNICODE(0x2665) *1%嗯嗯嗯啊%UNICODE(0x2665) *1%」
PRINTFORMW 「んﾞっ%UNICODE(0x2665) *1%んﾞっ%UNICODE(0x2665) *1%」	PRINTFORMW 「嗯啊%UNICODE(0x2665) *1%嗯啊%UNICODE(0x2665) *1%」
PRINTFORMW 「んっ%UNICODE(0x2665) *1%んあっ%UNICODE(0x2665) *1%」	PRINTFORMW 「嗯啊%UNICODE(0x2665) *1%嗯啊啊%UNICODE(0x2665) *1%」
PRINTFORMW 「あんっ%UNICODE(0x2665) *1%んっ%UNICODE(0x2665) *1%」	PRINTFORMW 「啊嗯啊%UNICODE(0x2665) *1%嗯啊%UNICODE(0x2665) *1%」
PRINTFORMW 「あﾞっ%UNICODE(0x2665) *1%んっ%UNICODE(0x2665) *1%」	PRINTFORMW 「啊啊%UNICODE(0x2665) *1%嗯啊%UNICODE(0x2665) *1%」
PRINTFORMW 「あっ%UNICODE(0x2665) *1%んっ%UNICODE(0x2665) *1%」	PRINTFORMW 「啊啊%UNICODE(0x2665) *1%嗯啊%UNICODE(0x2665) *1%」
PRINTFORMW 「んっ%UNICODE(0x2665) *1%あっ%UNICODE(0x2665)*1%おﾞっ%UNICODE(0x2665) *1%おﾞっ%UNICODE(0x2665) *1%」	PRINTFORMW 「嗯啊%UNICODE(0x2665) *1%啊啊%UNICODE(0x2665)*1%呜啊%UNICODE(0x2665) *1%呜啊%UNICODE(0x2665) *1%」
PRINTFORMW 「あっ%UNICODE(0x2665) *1%あんっ%UNICODE(0x2665) *1%」	PRINTFORMW 「啊啊%UNICODE(0x2665) *1%呜嗯啊%UNICODE(0x2665) *1%」
PRINTFORMW 「んんんっ%UNICODE(0x2665) *1%んﾞっ%UNICODE(0x2665) *1%」	PRINTFORMW 「嗯嗯嗯啊%UNICODE(0x2665) *1%嗯啊%UNICODE(0x2665) *1%」
PRINTFORMW 「あﾞっ%UNICODE(0x2665) *1%んﾞっ%UNICODE(0x2665) *1%駄目っ%UNICODE(0x2665) *1%」	PRINTFORMW 「啊%UNICODE(0x2665) *1%嗯啊%UNICODE(0x2665) *1%不行啊%UNICODE(0x2665) *1%」
PRINTFORMW 「んんっ%UNICODE(0x2665) *1%んんっ%UNICODE(0x2665) *1%」	PRINTFORMW 「嗯嗯啊%UNICODE(0x2665) *1%嗯嗯啊%UNICODE(0x2665) *1%」
PRINTFORMW 「んっ%UNICODE(0x2665) *1%待ってっ%UNICODE(0x2665) *1%駄目っ%UNICODE(0x2665) *1%」	PRINTFORMW 「嗯啊%UNICODE(0x2665) *1%等等%UNICODE(0x2665) *1%不行%UNICODE(0x2665) *1%」
PRINTFORMW 「んっ%UNICODE(0x2665) *1%んっ%UNICODE(0x2665) *1%」	PRINTFORMW 「嗯啊%UNICODE(0x2665) *1%嗯啊%UNICODE(0x2665) *1%」
PRINTFORMW 「んっ%UNICODE(0x2665) *1%あっ%UNICODE(0x2665) *1%」	PRINTFORMW 「嗯啊%UNICODE(0x2665) *1%啊啊%UNICODE(0x2665) *1%」
PRINTFORMW 「あっ%UNICODE(0x2665) *1%んっ%UNICODE(0x2665) *1%んっ%UNICODE(0x2665) *1%」	PRINTFORMW 「啊啊%UNICODE(0x2665) *1%嗯啊%UNICODE(0x2665) *1%嗯啊%UNICODE(0x2665) *1%」
PRINTFORMW 「あﾞっ%UNICODE(0x2665) *1%駄目っ%UNICODE(0x2665) *1%っ%UNICODE(0x2665) *1%」	PRINTFORMW 「啊啊%UNICODE(0x2665) *1%不行%UNICODE(0x2665) *1%啊%UNICODE(0x2665) *1%」
PRINTFORMW 「んっ%UNICODE(0x2665) *1%くすぐったいっ%UNICODE(0x2665) *1%」	PRINTFORMW 「嗯啊%UNICODE(0x2665) *1%痒痒的%UNICODE(0x2665) *1%」
PRINTFORMW 「そこっ%UNICODE(0x2665) *1%敏感だからぁ%UNICODE(0x2665) *1%」	PRINTFORMW 「那里%UNICODE(0x2665) *1%很敏感的%UNICODE(0x2665) *1%」
PRINTFORMW 「そこはっ%UNICODE(0x2665) *1%ダメぇっ%UNICODE(0x2665) *1%」	PRINTFORMW 「那里是%UNICODE(0x2665) *1%不行%UNICODE(0x2665) *1%」
PRINTFORMW 「ダメっ%UNICODE(0x2665) *1%生チンポでイクっ%UNICODE(0x2665)*1%%UNICODE(0x2665) *1%%UNICODE(0x2665) *1%」	PRINTFORMW 「不行%UNICODE(0x2665) *1%用不戴套的小鸡鸡去了%UNICODE(0x2665)*1%%UNICODE(0x2665) *1%%UNICODE(0x2665) *1%」
PRINTFORMW 「んっ%UNICODE(0x2665) *1%イクっ%UNICODE(0x2665) *1%んんっ%UNICODE(0x2665) *1%」	PRINTFORMW 「嗯啊%UNICODE(0x2665) *1%去了%UNICODE(0x2665) *1%嗯嗯啊%UNICODE(0x2665) *1%」
PRINTFORMW 「んっ%UNICODE(0x2665) *1%ああっ%UNICODE(0x2665) *1%んっ%UNICODE(0x2665) *1%」	PRINTFORMW 「嗯啊%UNICODE(0x2665) *1%啊啊啊%UNICODE(0x2665) *1%嗯啊%UNICODE(0x2665) *1%」
PRINTFORMW 「っ%UNICODE(0x2665) *1%っ%UNICODE(0x2665) *1%んっ%UNICODE(0x2665) *1%」	PRINTFORMW 「啊%UNICODE(0x2665) *1%啊%UNICODE(0x2665) *1%嗯啊%UNICODE(0x2665) *1%」
PRINTFORMW 「んっ%UNICODE(0x2665) *1%んんっ%UNICODE(0x2665)*1%いいっ%UNICODE(0x2665) *1%好きっ%UNICODE(0x2665) *1%」	PRINTFORMW 「嗯啊%UNICODE(0x2665) *1%嗯嗯啊%UNICODE(0x2665)*1%好舒服%UNICODE(0x2665) *1%喜欢%UNICODE(0x2665) *1%」
PRINTFORMW 「んっ%UNICODE(0x2665) *1%これっ%UNICODE(0x2665) *1%好きっ%UNICODE(0x2665) *1%」	PRINTFORMW 「嗯啊%UNICODE(0x2665) *1%这样%UNICODE(0x2665) *1%喜欢%UNICODE(0x2665) *1%」
PRINTFORMW 「んっ%UNICODE(0x2665) *1%んﾞっ%UNICODE(0x2665) *1%んっ%UNICODE(0x2665) *1%」	PRINTFORMW 「嗯啊%UNICODE(0x2665) *1%嗯啊%UNICODE(0x2665) *1%嗯啊%UNICODE(0x2665) *1%」
PRINTFORMW 「っ%UNICODE(0x2665) *1%あんっ%UNICODE(0x2665) *1%んっ%UNICODE(0x2665) *1%」	PRINTFORMW 「啊%UNICODE(0x2665) *1%啊嗯啊%UNICODE(0x2665) *1%嗯啊%UNICODE(0x2665) *1%」
PRINTFORMW 「んっ%UNICODE(0x2665) *1%ダメっ%UNICODE(0x2665)*1%%UNICODE(0x2665) *1%%UNICODE(0x2665) *1%」	PRINTFORMW 「嗯啊%UNICODE(0x2665) *1%不行%UNICODE(0x2665)*1%%UNICODE(0x2665) *1%%UNICODE(0x2665) *1%」
PRINTFORMW 「んっ%UNICODE(0x2665) *1%んっ%UNICODE(0x2665) *1%おﾞっ%UNICODE(0x2665) *1%」	PRINTFORMW 「哦按%UNICODE(0x2665) *1%嗯啊%UNICODE(0x2665) *1%呜啊%UNICODE(0x2665) *1%」
PRINTFORMW 「んっ%UNICODE(0x2665) *1%おﾞっ%UNICODE(0x2665) *1%んあっ%UNICODE(0x2665) *1%」	PRINTFORMW 「嗯啊%UNICODE(0x2665) *1%呜啊%UNICODE(0x2665) *1%嗯啊啊%UNICODE(0x2665) *1%」
PRINTFORMW 「んっ%UNICODE(0x2665) *1%んんっ%UNICODE(0x2665) *1%もっとっ%UNICODE(0x2665) *1%」	PRINTFORMW 「嗯啊%UNICODE(0x2665) *1%嗯嗯啊%UNICODE(0x2665) *1%更多更多%UNICODE(0x2665) *1%」
PRINTFORMW 「あんっ%UNICODE(0x2665) *1%んあっ%UNICODE(0x2665) *1%」	PRINTFORMW 「啊嗯啊%UNICODE(0x2665) *1%嗯啊啊%UNICODE(0x2665) *1%」
PRINTFORMW 「んっ%UNICODE(0x2665) *1%おおﾞっ%UNICODE(0x2665) *1%」	PRINTFORMW 「嗯啊%UNICODE(0x2665) *1%呜呜啊%UNICODE(0x2665) *1%」
PRINTFORMW 「お尻っ%UNICODE(0x2665) *1%ダメっ%UNICODE(0x2665) *1%」	PRINTFORMW 「屁股%UNICODE(0x2665) *1%不行%UNICODE(0x2665) *1%」
PRINTFORMW 「んっ%UNICODE(0x2665) *1%んんっ%UNICODE(0x2665) *1%」	PRINTFORMW 「嗯啊%UNICODE(0x2665) *1%嗯嗯啊%UNICODE(0x2665) *1%」
PRINTFORMW 「んっ%UNICODE(0x2665) *1%ダメっ%UNICODE(0x2665) *1%」	PRINTFORMW 「嗯啊%UNICODE(0x2665) *1%不行%UNICODE(0x2665) *1%」
PRINTFORMW 「そこっ%UNICODE(0x2665) *1%敏感だからっ%UNICODE(0x2665) *1%」	PRINTFORMW 「那里%UNICODE(0x2665) *1%那里很敏感%UNICODE(0x2665) *1%」
PRINTFORMW 「んん～っ%UNICODE(0x2665) *1%」	PRINTFORMW 「嗯嗯～啊%UNICODE(0x2665) *1%」
PRINTFORMW 「へぇ、こんなので射精しちゃうのね」	PRINTFORMW 「诶、这样就会射精的吧」
PRINTFORMW 「臭……」	PRINTFORMW 「好臭……」
PRINTFORMW 「うわ……気持ち悪……%UNICODE(0x2665) *1%」	PRINTFORMW 「哇……好恶心……%UNICODE(0x2665) *1%」
PRINTFORMW 「射精しすぎよ……もうっ……%UNICODE(0x2665) *1%」	PRINTFORMW 「射太多了啦……真是的……%UNICODE(0x2665) *1%」
PRINTFORMW 「ゴム付けといて良かった……妊娠しちゃうところだったわね」	PRINTFORMW 「有戴套真是太好了……差点就要怀孕了」
PRINTFORMW 「そんなに射精して気持ちよかったの？」	PRINTFORMW 「射了这么多很舒服吧？」
PRINTFORMW 「んん……んんっ%UNICODE(0x2665) *1%」	PRINTFORMW 「嗯嗯……嗯嗯啊%UNICODE(0x2665) *1%」
PRINTFORMW 「ん……んん……んぇ……%UNICODE(0x2665) *1%」	PRINTFORMW 「嗯……嗯嗯……嗯诶……%UNICODE(0x2665) *1%」
PRINTFORMW 「ん……んんんんん～～～%UNICODE(0x2665) *1%」	PRINTFORMW 「嗯……嗯嗯嗯嗯嗯～～～%UNICODE(0x2665) *1%」
PRINTFORMW 「ん%UNICODE(0x2665) *1%もうっ射精しすぎ……%UNICODE(0x2665) *1%」	PRINTFORMW 「嗯%UNICODE(0x2665) *1%真是的射太多啦……%UNICODE(0x2665) *1%」
PRINTFORMW 「んんっ%UNICODE(0x2665) *1%……いきなり射精しないでよ」	PRINTFORMW 「嗯嗯啊%UNICODE(0x2665) *1%……不要突然射出来啊」
PRINTFORMW 「んん%UNICODE(0x2665) *1%んっ……%UNICODE(0x2665) *1%」	PRINTFORMW 「嗯嗯%UNICODE(0x2665) *1%嗯啊……%UNICODE(0x2665) *1%」
PRINTFORMW 「全くこんな気持ちの悪い赤ん坊がいるなんてね……」	PRINTFORMW 「真是的居然有这么恶心的婴儿存在呢……」
PRINTFORMW 「そんなにおっぱい好きなの？」	PRINTFORMW 「这么喜欢胸部吗？」
PRINTFORMW 「んっ……うわ……本当に射精した……」	PRINTFORMW 「嗯啊……哇……真的射精了……」
PRINTFORMW 凍てついた時の中で%CALLNAME:MASTER%は蓮子の口腔に精液を吐き出した。	PRINTFORMW 在冻结的时空中%CALLNAME:MASTER%在蓮子的口中把精液射了出来。
PRINTFORMW 「うぇ……射精しすぎ……%UNICODE(0x2665) *1%」	PRINTFORMW 「呜诶……射太多了……%UNICODE(0x2665) *1%」
PRINTFORMW 「んんっ……んっ……%UNICODE(0x2665) *1%」	PRINTFORMW 「嗯嗯啊……嗯啊……%UNICODE(0x2665) *1%」
PRINTFORMW 「どんだけ溜めてたのよ……%UNICODE(0x2665) *1%」	PRINTFORMW 「到底积攒了多少啊……%UNICODE(0x2665) *1%」
PRINTFORMW 蓮子の口から溢れ出た精液が胸の上に垂れている。	PRINTFORMW 从蓮子嘴里溢出的精液垂到了胸前。
PRINTFORMW 「ん～%UNICODE(0x2665) *1%んんっ%UNICODE(0x2665) *1%」	PRINTFORMW 「嗯～%UNICODE(0x2665) *1%嗯嗯啊%UNICODE(0x2665) *1%」
PRINTFORMW 「あんまり気持ちいいとこうなるのね……%UNICODE(0x2665) *1%」	PRINTFORMW 「太舒服的话会变成这样呢……%UNICODE(0x2665) *1%」
PRINTFORMW 「どう？私のおっぱいも捨てたもんじゃないでしょ%UNICODE(0x2665) *1%」	PRINTFORMW 「怎样？我的乳房也不是一般货色对吧%UNICODE(0x2665) *1%」
PRINTFORMW 「んっ%UNICODE(0x2665) *1%んんﾞっ%UNICODE(0x2665) *1%」	PRINTFORMW 「嗯啊%UNICODE(0x2665) *1%嗯嗯啊%UNICODE(0x2665) *1%」
PRINTFORMW 「ん%UNICODE(0x2665) *1%んんっ%UNICODE(0x2665) *1%」	PRINTFORMW 「嗯%UNICODE(0x2665) *1%嗯嗯啊%UNICODE(0x2665) *1%」
PRINTFORMW 「ん……変な味ね、癖になりそう」	PRINTFORMW 「嗯……奇怪的味道、快要上瘾了」
PRINTFORMW 「んっ%UNICODE(0x2665) *1%ん～っ%UNICODE(0x2665) *1%」	PRINTFORMW 「嗯啊%UNICODE(0x2665) *1%嗯～啊%UNICODE(0x2665) *1%」
PRINTFORMW 「ますます汚れちゃったわね……%UNICODE(0x2665) *1%」	PRINTFORMW 「越来越脏了呢……%UNICODE(0x2665) *1%」
PRINTFORMW 「もう、こんなことで射精したら駄目じゃない……%UNICODE(0x2665) *1%」	PRINTFORMW 「真是的、做这种事的时候射精可不行啊……%UNICODE(0x2665) *1%」
PRINTFORMW 「折角私が洗ってあげたのにね……%UNICODE(0x2665) *1%」	PRINTFORMW 「好不容易我给你洗干净了……%UNICODE(0x2665) *1%」
PRINTFORMW 「女の子に踏まれて射精するなんてとんだ変態ねぇ%UNICODE(0x2665) *1%」	PRINTFORMW 「被女孩子踩着射精、真是变态呢%UNICODE(0x2665) *1%」
PRINTFORMW 「私の足で踏まれるの、そんなに気持ちよかったんだ？ふーん」	PRINTFORMW 「被我的脚踩、竟然这么舒服啊？芙呜」
PRINTFORMW 「私に踏まれてそんな情けない顔しないでよ……もっと踏みたくなるじゃない」	PRINTFORMW 「不要被我踩着就露出那么不成器的表情啊……不是让我变得更想踩你吗」
PRINTFORMW 「挿入する前に射精するなんてとんだ早漏ね%UNICODE(0x2665) *1%」	PRINTFORMW 「在插入之前就射精真是意外的早泄啊%UNICODE(0x2665) *1%」
PRINTFORMW 「メリーほどじゃないけど中々のもんでしょ？」	PRINTFORMW 「虽然比不上梅莉但也很不错吧？」
PRINTFORMW 「なんかすごい達成感あるわね……%UNICODE(0x2665) *1%」	PRINTFORMW 「总觉得很有成就感呢……%UNICODE(0x2665) *1%」
PRINTFORMW 「どう？私の胸も大したもんでしょ%UNICODE(0x2665) *1%」	PRINTFORMW 「怎样？我的胸也很厉害吧%UNICODE(0x2665) *1%」
PRINTFORMW 「とても濃くて臭いわ……%UNICODE(0x2665) *1%」	PRINTFORMW 「非常的浓味道很臭啊……%UNICODE(0x2665) *1%」
PRINTFORMW 「ん～%UNICODE(0x2665) *1%んっ%UNICODE(0x2665) *1%」	PRINTFORMW 「嗯～%UNICODE(0x2665) *1%嗯啊%UNICODE(0x2665) *1%」
PRINTFORMW （こんなの中だしされたら……）	PRINTFORMW （要是这时候被中出的话……）
PRINTFORMW 蓮子の口から溢れ出た精液が口から垂れている。	PRINTFORMW 从蓮子嘴里溢出的精液从嘴旁垂下来。
PRINTFORMW 「んっ%UNICODE(0x2665) *1%んっ%UNICODE(0x2665) *1%ゲホッ%UNICODE(0x2665) *1%」	PRINTFORMW 「嗯啊%UNICODE(0x2665) *1%嗯啊%UNICODE(0x2665) *1%咳咳%UNICODE(0x2665) *1%」
PRINTFORMW 「ん%UNICODE(0x2665) *1%……気持ち悪い……%UNICODE(0x2665) *1%」	PRINTFORMW 「嗯%UNICODE(0x2665) *1%……好恶心……%UNICODE(0x2665) *1%」
PRINTFORMW 「んうっ……うぇっ」	PRINTFORMW 「嗯唔……唔诶～」
PRINTFORMW 「ん～っ……んっ……」	PRINTFORMW 「嗯～啊……嗯啊……」
PRINTFORMW 凍てついた時の中で%CALLNAME:MASTER%は蓮子の指に精液を吐き出した。	PRINTFORMW 在冻结的时空中%CALLNAME:MASTER%用蓮子的手把精液射了出来。
PRINTFORMW 「うわっ……引くほど射精するわね……」	PRINTFORMW 「呜哇……这样撸着就会射精呢……」
PRINTFORMW 「私の手、そんなによかった？……ふーん」	PRINTFORMW 「我的手、那么舒服吗？……芙呜」
PRINTFORMW 「……なんかすごい気持ちよさそうな顔してるわね」	PRINTFORMW 「……你看起来很舒服的样子呢」
PRINTFORMW 凍てついた時の中で%CALLNAME:MASTER%は蓮子のアナルに精液を吐き出した。	PRINTFORMW 在冻结的时空中%CALLNAME:MASTER%在蓮子的肛门里把精液射了出来。
PRINTFORMW 「ん%UNICODE(0x2665) *1%……ちょっと気持ちよかったわ」	PRINTFORMW 「嗯%UNICODE(0x2665) *1%……有点舒服呢」
PRINTFORMW 「んひっぃ%UNICODE(0x2665) *1%」	PRINTFORMW 「呢嘻嘻%UNICODE(0x2665) *1%」
PRINTFORMW 「んっ%UNICODE(0x2665) *1%すごい違和感……%UNICODE(0x2665) *1%」	PRINTFORMW 「嗯啊%UNICODE(0x2665) *1%好强的违和感……%UNICODE(0x2665) *1%」
PRINTFORMW 「ああ～～～っ%UNICODE(0x2665) *1%%UNICODE(0x2665) *1%%UNICODE(0x2665) *1%」	PRINTFORMW 「啊啊～～～啊%UNICODE(0x2665) *1%%UNICODE(0x2665) *1%%UNICODE(0x2665) *1%」
PRINTFORMW 「ああっ%UNICODE(0x2665) *1%あああ～～～%UNICODE(0x2665) *1%」	PRINTFORMW 「啊啊啊%UNICODE(0x2665) *1%啊啊啊～～～%UNICODE(0x2665) *1%」
PRINTFORMW 「んんっ%UNICODE(0x2665) *1%あああっ%UNICODE(0x2665) *1%」	PRINTFORMW 「嗯嗯啊%UNICODE(0x2665) *1%啊啊啊啊%UNICODE(0x2665) *1%」
PRINTFORMW 「っ%UNICODE(0x2665) *1%あああっ%UNICODE(0x2665) *1%」	PRINTFORMW 「啊%UNICODE(0x2665) *1%啊啊啊啊%UNICODE(0x2665) *1%」
PRINTFORMW （……なんだか幸せな感じがするわね……）	PRINTFORMW （……总觉得很幸福呢……）
PRINTFORMW 「お互いに舐めあうなんて道化芝居よ」	PRINTFORMW 「互相舔舐什么的简直是小丑剧场啊」
PRINTFORMW 「んん%UNICODE(0x2665) *1%んっ%UNICODE(0x2665) *1%ん～っ%UNICODE(0x2665) *1%」	PRINTFORMW 「嗯嗯%UNICODE(0x2665) *1%嗯啊%UNICODE(0x2665) *1%嗯～啊%UNICODE(0x2665) *1%」
PRINTFORMW 「……この臭い好きよ%UNICODE(0x2665) *1%」	PRINTFORMW 「……我喜欢这个味道%UNICODE(0x2665) *1%」
PRINTFORMW 「出しちゃえばいいのに%UNICODE(0x2665) *1%」	PRINTFORMW 「快点射出来就行了%UNICODE(0x2665) *1%」
PRINTFORMW 「んん……だんだんなんか出てきた……%UNICODE(0x2665) *1%」	PRINTFORMW 「嗯嗯……一点一点出来了……%UNICODE(0x2665) *1%」
PRINTFORMW 「んんっんっ%UNICODE(0x2665) *1%」	PRINTFORMW 「嗯嗯%UNICODE(0x2665) *1%」
PRINTFORMW 「ん……%UNICODE(0x2665) *1%ん～……%UNICODE(0x2665) *1%」	PRINTFORMW 「嗯……%UNICODE(0x2665) *1%嗯～……%UNICODE(0x2665) *1%」
PRINTFORMW 「んんんんっ%UNICODE(0x2665) *1%%UNICODE(0x2665) *1%%UNICODE(0x2665) *1%」	PRINTFORMW 「嗯嗯嗯嗯%UNICODE(0x2665) *1%%UNICODE(0x2665) *1%%UNICODE(0x2665) *1%」
PRINTFORMW 「私の舌使いも大したもんでしょ%UNICODE(0x2665) *1%」	PRINTFORMW 「我的舌技也很厉害吧%UNICODE(0x2665) *1%」
PRINTFORMW 「んんん？」	PRINTFORMW 「嗯嗯嗯？」
PRINTFORMW 「もっと私の方も舐めてよねっ%UNICODE(0x2665) *1%」	PRINTFORMW 「之后也多舔舔我吧%UNICODE(0x2665) *1%」
PRINTFORMW 「んっ……んんっ%UNICODE(0x2665) *1%」	PRINTFORMW 「嗯……嗯嗯%UNICODE(0x2665) *1%」
PRINTFORMW 「んんっ……っ%UNICODE(0x2665) *1%」	PRINTFORMW 「嗯嗯……啊%UNICODE(0x2665) *1%」
PRINTFORMW 「ん……んっ……%UNICODE(0x2665) *1%」	PRINTFORMW 「嗯……嗯……%UNICODE(0x2665) *1%」
PRINTFORMW 「……んっ……あんっ……」	PRINTFORMW 「……嗯……啊恩……」
PRINTFORMW 「……んっ……んっ……」	PRINTFORMW 「……嗯……嗯……」
PRINTFORMW 「日本文化ってのも知らないことが多いわね」	PRINTFORMW 「日本文化什么的我也有很多不知道的地方呢」
PRINTFORMW 「ちょっと刺激しすぎっ%UNICODE(0x2665) *1%」	PRINTFORMW 「有点太刺激了%UNICODE(0x2665) *1%」
PRINTFORMW 「あっ%UNICODE(0x2665) *1%あっ%UNICODE(0x2665) *1%んっ%UNICODE(0x2665) *1%」	PRINTFORMW 「啊%UNICODE(0x2665) *1%啊%UNICODE(0x2665) *1%嗯%UNICODE(0x2665) *1%」
PRINTFORMW 「んっ%UNICODE(0x2665) *1%ちょっと待ってっ%UNICODE(0x2665) *1%」	PRINTFORMW 「嗯%UNICODE(0x2665) *1%等等%UNICODE(0x2665) *1%」
PRINTFORMW 「んっ%UNICODE(0x2665) *1%あっ%UNICODE(0x2665) *1%んっ%UNICODE(0x2665) *1%」	PRINTFORMW 「嗯%UNICODE(0x2665) *1%啊%UNICODE(0x2665) *1%嗯%UNICODE(0x2665) *1%」
PRINTFORMW 「急に刺激されるとびっくりするじゃない……」	PRINTFORMW 「突然被刺激那里的话会吓一跳的……」
PRINTFORMW 「んんっ……！そこは敏感だから……！」	PRINTFORMW 「嗯嗯……！那里很敏感的……！」
PRINTFORMW 「んっ%UNICODE(0x2665) *1%待って……深いの来た……%UNICODE(0x2665) *1%」	PRINTFORMW 「嗯%UNICODE(0x2665) *1%等等……到深处了……%UNICODE(0x2665) *1%」
PRINTFORMW 「手で扱いて舐めろって……最悪ね」	PRINTFORMW 「用手和嘴一起做……最糟糕了」
PRINTFORMW 「んっ早く射精しなさいよ……%UNICODE(0x2665) *1%」	PRINTFORMW 「嗯快点射精吧……%UNICODE(0x2665) *1%」
PRINTFORMW 「こんなのを舐めろだなんてっ%UNICODE(0x2665) *1%」	PRINTFORMW 「竟然要舔这种东西%UNICODE(0x2665) *1%」
PRINTFORMW 「んっ……臭い……%UNICODE(0x2665) *1%」	PRINTFORMW 「嗯……好臭……%UNICODE(0x2665) *1%」
PRINTFORMW 「んっ……くっさ……%UNICODE(0x2665) *1%」	PRINTFORMW 「嗯……好臭……%UNICODE(0x2665) *1%」
PRINTFORMW 「んんっ……早く済ませてよね」	PRINTFORMW 「嗯嗯……快点出来哦」
PRINTFORMW 「ん……臭い」	PRINTFORMW 「嗯……好臭」
PRINTFORMW 「れろ……これでいいの？」	PRINTFORMW 「呸咯……这样就可以了？」
PRINTFORMW 「んんっ……れろっ」	PRINTFORMW 「嗯嗯……呸咯」
PRINTFORMW 「あっ%UNICODE(0x2665) *1%んっ%UNICODE(0x2665) *1%弱いとこダメっ%UNICODE(0x2665) *1%」	PRINTFORMW 「啊%UNICODE(0x2665) *1%嗯%UNICODE(0x2665) *1%那里很弱的不行%UNICODE(0x2665) *1%」
PRINTFORMW 「んっ%UNICODE(0x2665) *1%んんっ%UNICODE(0x2665) *1%んおっ%UNICODE(0x2665) *1%」	PRINTFORMW 「嗯%UNICODE(0x2665) *1%嗯嗯%UNICODE(0x2665) *1%嗯哦%UNICODE(0x2665) *1%」
PRINTFORMW 「もっとっ%UNICODE(0x2665) *1%んっ%UNICODE(0x2665) *1%んんっ%UNICODE(0x2665) *1%」	PRINTFORMW 「更多更多%UNICODE(0x2665) *1%嗯%UNICODE(0x2665) *1%嗯嗯%UNICODE(0x2665) *1%」
PRINTFORMW 「あっ%UNICODE(0x2665) *1%ああっ%UNICODE(0x2665) *1%」	PRINTFORMW 「啊%UNICODE(0x2665) *1%啊啊%UNICODE(0x2665) *1%」
PRINTFORMW 「んっ%UNICODE(0x2665) *1%ちょっとっ%UNICODE(0x2665) *1%深いのっ%UNICODE(0x2665) *1%」	PRINTFORMW 「嗯%UNICODE(0x2665) *1%等等%UNICODE(0x2665) *1%好深%UNICODE(0x2665) *1%」
PRINTFORMW 「んっ%UNICODE(0x2665) *1%もっとっ%UNICODE(0x2665) *1%んっ%UNICODE(0x2665) *1%」	PRINTFORMW 「嗯%UNICODE(0x2665) *1%更多更多%UNICODE(0x2665) *1%嗯%UNICODE(0x2665) *1%」
PRINTFORMW 「あっ%UNICODE(0x2665) *1%おおっ%UNICODE(0x2665) *1%んっ%UNICODE(0x2665) *1%」	PRINTFORMW 「啊%UNICODE(0x2665) *1%呜呜%UNICODE(0x2665) *1%嗯%UNICODE(0x2665) *1%」
PRINTFORMW 「こんな態勢で胸で擦れだなんて変態ね……%UNICODE(0x2665) *1%」	PRINTFORMW 「以这样的姿势在胸前摩擦真是变态啊……%UNICODE(0x2665) *1%」
PRINTFORMW 「これでもテクニックはあると思うんだけど……」	PRINTFORMW 「我觉得这个也是有技巧的说……」
PRINTFORMW 「んっ……もう！パイズリに集中できないじゃない……」	PRINTFORMW 「恩……真是的！我都不能集中精神乳交了……」
PRINTFORMW 「んんっ%UNICODE(0x2665) *1%んっ%UNICODE(0x2665) *1%」	PRINTFORMW 「嗯嗯%UNICODE(0x2665) *1%嗯%UNICODE(0x2665) *1%」
PRINTFORMW 「……身体の柔らかさで射精されても困るんだけど」	PRINTFORMW 「……因为身体的柔软而被射精也很困扰的」
PRINTFORMW 「んっ……こうかしら……%UNICODE(0x2665) *1%」	PRINTFORMW 「嗯……怎么样……%UNICODE(0x2665) *1%」
PRINTFORMW 「……んっ……これでいいの？」	PRINTFORMW 「……嗯……这样就可以了？」
PRINTFORMW 「私だってこれぐらいは……！」	PRINTFORMW 「就算是我这种程度还是能做到的……！」
PRINTFORMW 「どう？私の胸も捨てたもんじゃないでしょ%UNICODE(0x2665) *1%」	PRINTFORMW 「怎样？我的胸也不是一般货色对吧%UNICODE(0x2665) *1%」
PRINTFORMW 「私の胸でイっちゃえ%UNICODE(0x2665) *1%」	PRINTFORMW 「用我的胸部去吧%UNICODE(0x2665) *1%」
PRINTFORMW 「ふふっ……ちゅぅっ……%UNICODE(0x2665) *1%」	PRINTFORMW 「呼呼～……啾呜……%UNICODE(0x2665) *1%」
PRINTFORMW 「んーこんな感じ？」	PRINTFORMW 「嗯—这样吗？」
PRINTFORMW 「これってチンポの方も大きくないといけないのよねぇ」	PRINTFORMW 「这样不让小鸡鸡变大变硬可不行对吧」
PRINTFORMW 「こうしてると可愛いわよねコレも%UNICODE(0x2665) *1%」	PRINTFORMW 「这样看的话很可爱呢%UNICODE(0x2665) *1%」
PRINTFORMW 「んおっ%UNICODE(0x2665) *1%んんっ%UNICODE(0x2665) *1%」	PRINTFORMW 「嗯啊%UNICODE(0x2665) *1%嗯嗯%UNICODE(0x2665) *1%」
PRINTFORMW 「んっ%UNICODE(0x2665) *1%んっ%UNICODE(0x2665) *1%おっ%UNICODE(0x2665) *1%」	PRINTFORMW 「嗯%UNICODE(0x2665) *1%嗯%UNICODE(0x2665) *1%啊%UNICODE(0x2665) *1%」
PRINTFORMW 「んおっ%UNICODE(0x2665) *1%おぉっ%UNICODE(0x2665) *1%」	PRINTFORMW 「嗯啊%UNICODE(0x2665) *1%啊啊%UNICODE(0x2665) *1%」
PRINTFORMW 「んっ……深いっ……」	PRINTFORMW 「嗯……好深……」
PRINTFORMW 「んっ……おおっ……%UNICODE(0x2665) *1%」	PRINTFORMW 「嗯……啊啊……%UNICODE(0x2665) *1%」
PRINTFORMW 「駄目っ%UNICODE(0x2665) *1%ちょっとっ%UNICODE(0x2665) *1%ぐりぐりしないでっ%UNICODE(0x2665) *1%」	PRINTFORMW 「不行%UNICODE(0x2665) *1%等等%UNICODE(0x2665) *1%不要磨磨蹭蹭的呀%UNICODE(0x2665) *1%」
PRINTFORMW 「%CALLNAME:MASTER%と話をするつもりは無いんだけど、分からない？」	PRINTFORMW 「我没有和%CALLNAME:MASTER%说话的心情、明白吗？」
PRINTFORMW 蓮子は怒気をはらんだ声で返事した。	PRINTFORMW 蓮子用怒气冲冲的声音回到。
PRINTFORMW 「……そうねぇ、メリーならなんて言うかしらね」	PRINTFORMW 「……是呢、如果是梅莉的话会怎么说呢」
PRINTFORMW 蓮子は押し黙ってしまった。	PRINTFORMW 蓮子沉默了。
PRINTFORMW 「結界暴きも秘封倶楽部の活動よ！」	PRINTFORMW 「探寻结界也是秘封俱乐部的活动哟！」
PRINTFORMW 「メリーは嫌がるけどこういうところにこそ解れあるのよねぇ」	PRINTFORMW 「虽然梅莉不喜欢这里、但是也有在这里才能弄明白的事呢」
PRINTFORMW 「人の意識が電子の産物でしか無いならここはもっと煩くなるはずよ！」	PRINTFORMW 「如果人的意识只是电子运动的产物的话这里应该会更吵闹一点才对！」
PRINTFORMW 「霊感はない方だけど何だか人の気配がするわね」	PRINTFORMW 「虽然我没有灵感但还是觉得周围有人的气息呢」
PRINTFORMW 「お墓参りと言ってもここに私の祖先は居ないはずよ？」	PRINTFORMW 「虽说是来扫墓的但这里应该没有我的祖先吧？」
PRINTFORMW 「メリーが夢で竹林の中に居たって聞いたけどここかしら？」	PRINTFORMW 「梅莉做了一个身处竹林的梦、应该就是这里吧？」
PRINTFORMW 「へぇ、どこまでも道に迷ってしまいそうね」	PRINTFORMW 「诶、无论到哪里都会迷路呢」
PRINTFORMW 「天然物のタケノコなんて滅多に見られないものね」	PRINTFORMW 「天然的竹笋很少能看到呢」
PRINTFORMW 「一度来てみたかったのよ、話だけは聞いていたからね」	PRINTFORMW 「我一直想来这里一次、虽然只是听说过这里呢」
PRINTFORMW 「火だるまの少女……火鼠の皮衣……きっとメリーが見たのはかぐや姫よ！」	PRINTFORMW 「火红不倒翁一样的少女……火鼠的皮裘……梅莉看到的一定是辉夜姬！」
PRINTFORMW 「メリーは彼岸花が嫌いらしいのよ」	PRINTFORMW 「梅莉好像不喜欢彼岸花哟」
PRINTFORMW 「何でだろ？似合うと思うけどなぁ」	PRINTFORMW 「为什么呢？明明很适合她的呢」
PRINTFORMW 「私は天国に行くわよ、地獄はここからでも行けるみたいだしね」	PRINTFORMW 「我以后是要上天堂的、地狱好像从这里也能去呢」
PRINTFORMW 「三途の川も数学的に計算できるらしいのよねぇ、誰に聞いたんだっけ」	PRINTFORMW 「三途川好像也能用数学来计算呢、是从谁那里听说的来着」
PRINTFORMW 「ここも財政難って聞いたけど世知辛いわねぇ、何かできることは無いかしら？」	PRINTFORMW 「听说这里的财政也很困难、真是世道艰辛啊、有什么我能做的吗？」
PRINTFORMW 「せっかくの機会だし閻魔様に挨拶してきましょうよ」	PRINTFORMW 「难得的机会去向阎魔大人打个招呼吧」
PRINTFORMW 「あまり見ないでよ、メリーと比べられたら恥ずかしいわ」	PRINTFORMW 「不要一直盯着看呀、要是被和梅莉比较的话那太羞人了」
PRINTFORMW 「ふぅ……いい湯ね……」	PRINTFORMW 「呼～……真是好水啊……」
PRINTFORMW 「裸の付き合いも良いものね」	PRINTFORMW 「坦诚相见也不错呢」
PRINTFORMW 「こちらの世界も春は陽気なのね」	PRINTFORMW 「这个世界的春天也让人舒适呢」
PRINTFORMW 「タケノコは今が旬ね、天然物がここにあるって聞いたけど……」	PRINTFORMW 「现在正是竹笋的时节呢、我听说这里有野生的……」
PRINTFORMW 「大きな桜の木を見たことがあるわ、まるで夢のような景色だったわね」	PRINTFORMW 「我在这里见过很大的樱花树、简直就像梦一样的景色呢」
PRINTFORMW 「あっつ……ノースリーブにして良かったわ……」	PRINTFORMW 「好热……还好穿了无袖的衣服……」
PRINTFORMW 「水着持ってきてないのよね……まあ知り合いメリーぐらいしかいないからいいけど」	PRINTFORMW 「没有把泳衣带过来呢……不过我在这里的熟人的人只有梅莉一个也无所谓了」
PRINTFORMW 「夏はどうしても暑いわね……地獄の釜も茹っているのかしら？」	PRINTFORMW 「夏天为什么这么热啊……是地狱的锅在煮什么吗？」
PRINTFORMW 「秋になって涼しくなって助かるわ」	PRINTFORMW 「到了秋天天气变凉了真是太好了」
PRINTFORMW 「日本らしい季節になったわね、メリーもさぞ満喫しているでしょうね」	PRINTFORMW 「到了有日本风格的季节了呢、梅莉也一定也很享受吧」
PRINTFORMW 「紅葉って神様が手で塗ってるんだっけ？神様ってよりまるで風景画家ね」	PRINTFORMW 「红叶好像是神明大人亲手涂的的吧？比起神来说更像是风景画家啊」
PRINTFORMW 「寒い季節になってきたけど暖房器具って布団以上の物は無いのよね」	PRINTFORMW 「虽然到了寒冷的季节、但是这里没有除了被子以外的取暖用具呢」
PRINTFORMW 「雪も降る日はお酒を飲んで過ごすに限るわね」	PRINTFORMW 「下雪的日子当然要是喝酒度过呢」
PRINTFORMW 「こたつに鍋って古典的だけど素敵じゃない？」	PRINTFORMW 「窝在被炉里吃火锅虽然很古典但也很棒吧？」
PRINTFORMW 「%CALLNAME:MASTER%の見る景色を私も見れて幸せよ」	PRINTFORMW 「能看到和%CALLNAME:MASTER%看到一样的风景我很幸福」
PRINTFORMW 「%CALLNAME:MASTER%は私の見る景色を見てどう思った？」	PRINTFORMW 「%CALLNAME:MASTER%看了我所看到的景色后有什么感想？」
PRINTFORMW 「ヴァーチャルが現実に勝てない道理は無いわ、少なくとも%CALLNAME:MASTER%は素敵よ？」	PRINTFORMW 「没有虚幻就赢不了现实的道理、至少%CALLNAME:MASTER%就很棒哟？」
PRINTFORMW 「%CALLNAME:MASTER%と居ると落ち着くのよね、何でかしら？そういう粒子でも出てる？」	PRINTFORMW 「有%CALLNAME:MASTER%在身边我就能平静下来呢、为什么呢？是会散发那种功效的粒子吗？」
PRINTFORMW 「私の眼にかかれば場所と時間が分かるのよ」	PRINTFORMW 「我通过眼睛就能知道时间与地点哟」
PRINTFORMW 当然ここがどこだかもね	PRINTFORMW 当然也知道这里是哪里哦
PRINTFORMW 「宇宙にはロマンがあるけどこの世界も無限の観測外の世界が広がっていて素敵よね」	PRINTFORMW 「虽然宇宙也很浪漫、但是这个世界里有着无数未观测的世界、真是太棒了」
PRINTFORMW 「物質の構成単位を最小単位まで遡れば%CALLNAME:MASTER%も私も同じなのよ、だから当然相性が良いってわけ」	PRINTFORMW 「以构成物质的最小单位来看%CALLNAME:MASTER%和我都是一样的、所以我们的相性当然很好」
PRINTFORMW 「観測物理学の世界はもはや哲学的になってしまったけどこの世界に広がるのは未だ観測しきれないわ」	PRINTFORMW 「观测物理学的世界现在已经变得哲学性了、但是在这个世界上还有很多没有观测到的东西」
PRINTFORMW 「合成卵と合成苺と私達、どう違うのかしら？」	PRINTFORMW 「合成鸡蛋和合成草莓和我们、有什么不同呢？」
PRINTFORMW 「%CALLNAME:MASTER%も一緒に同人誌を作りましょうよ、きっと楽しいわ！」	PRINTFORMW 「%CALLNAME:MASTER%也一起制作同人志吧、一定会很有趣的！」
PRINTFORMW 「全てが影響し合っているのなら主観なんて問題じゃ無いわ、客観こそが世界を作り上げるのよ」	PRINTFORMW 「如果世间一切都在相互影响的话那么主观就不是问题了、只有客观才能创造世界」
PRINTFORMW 「天国と地獄、どっちにも行ってみたいわね」	PRINTFORMW 「天堂和地狱、两边都想去看看呢」
PRINTFORMW 「メリーの眼も私の眼も変な物が見えるけど、%CALLNAME:MASTER%の眼は？」	PRINTFORMW 「梅莉的眼睛和我的眼睛都能看到些奇怪的东西、%CALLNAME:MASTER%的眼睛呢？」
PRINTFORMW 「でもここはメリーの見た夢とも違うっぽいのよねぇ」	PRINTFORMW 「但是这里好像和梅莉做的梦有些不一样呢」
PRINTFORMW 「天然物の素材ばかりでお酒も進むわね」	PRINTFORMW 「这里到处都是天然的素材、酒也很好喝」
PRINTFORMW 「宇宙の果てには何があるのかしら？遠く遠くへ行ってみたいわね」	PRINTFORMW 「宇宙的尽头到底有什么？想去那么遥远的地方看看呢」
PRINTFORMW 「古来鳥居は内と外を分ける結界、でも同時に鳥居同士を繋げるワープゾーンでもあるのよ」	PRINTFORMW 「自古以来鸟居都是分开内与外的结界、但是同时也是连接不同鸟居之间的跳跃区哟」
PRINTFORMW 「コズミックホラーでも何でもそうだけど観測限界の果てにあるのはつまらない現実だけよ」	PRINTFORMW 「不管是漫画是恐怖片还是什么观测极限的尽头只有无聊的现实」
PRINTFORMW 「だから私は夢を見るの」	PRINTFORMW 「所以我才会做梦」
PRINTFORMW 「夢と現実に有意差はないわ、人は想像することで世界を観測し続けてきたのにね	PRINTFORMW 「梦和现实没有显著的差别、因为人们一直通过想象来观测着世界
PRINTFORMW 「旧型酒ばかりってのも面白いわね」	PRINTFORMW 「这里有的净是旧型酒很有趣呢」
PRINTFORMW 「秘封倶楽部に入りたい？ダメよ、私達の間を引き裂こうなんて」	PRINTFORMW 「想加入秘封俱乐部？不行、居然想分裂我们之间的关系」
PRINTFORMW 「メリーは悲観主義だけど、私はロマンチストよ、夢があるの」	PRINTFORMW 「虽然梅莉是悲观主义者、但我是个浪漫主义者、有梦想的」
PRINTFORMW 「へえ？何？ナンパ？」	PRINTFORMW 「诶？什么？搭讪？」
PRINTFORMW 「このあたりの散策はもう済ませたわ」	PRINTFORMW 「在这一带的散步已经结束了」
PRINTFORMW 「匂いもするし音も聞こえる、夢じゃ無いわよねー」	PRINTFORMW 「能闻到气味也能听到声音、这不是梦啊」
PRINTFORMW 「あんたどういう神経してんのよ……」	PRINTFORMW 「你的脑子到底是个什么构造……」
PRINTFORMW 「……まあ日本茶らしいかもね」	PRINTFORMW 「……嘛、倒是有点日本茶的意思」
PRINTFORMW 「メリーが淹れた方が美味しいわね」	PRINTFORMW 「梅莉泡的比较好喝呢」
PRINTFORMW 「私が手本見せてあげよっか？」	PRINTFORMW 「我来示范一下吧？」
PRINTFORMW 「……次からは自分で淹れるわ」	PRINTFORMW 「……下次我会自己泡的」
PRINTFORMW 「……どうやったらこんな味になるのよ……」	PRINTFORMW 「……怎样泡才能变成这样的味道呢……」
PRINTFORMW 「ずずっ……へえ、上手いのね」	PRINTFORMW 「滋滋……诶、你泡得很好呢」
PRINTFORMW 「ずずっ……天然物は味が違うわね」	PRINTFORMW 「滋滋……天然的东西味道果然不一样啊」
PRINTFORMW 「ずずっ……結構なお点前ね」	PRINTFORMW 「滋滋……手艺不错」
PRINTFORMW 「ありがとう、頂くわ」	PRINTFORMW 「谢谢、多谢款待」
PRINTFORMW 「ふぅ……落ち着くわね、日本人だからかしら？」	PRINTFORMW 「呼～……让人平静呀、也许是因为是日本人吧？」
PRINTFORMW 「へぇ、こんな美女に背中を流してもらって緊張してるんだ？」	PRINTFORMW 「诶、被我这样的美女擦背很紧张吗？」
PRINTFORMW 「ほら、混浴してるんだからもっと遊びましょ」	PRINTFORMW 「你看、都在混浴了就多玩一会儿吧」
PRINTFORMW 「へぇ……%CALLNAME:MASTER%の身体って……ふーん」	PRINTFORMW 「诶……%CALLNAME:MASTER%的身体……呼嗯ー」
PRINTFORMW 「んっ、もっと強く揉んでもいいわよ」	PRINTFORMW 「嗯、揉的更用力些也没问题哟」
PRINTFORMW 「ちょっとどこ触ってるのよ……別に良いけど……」	PRINTFORMW 「等下你在摸哪里呀……虽然可以啦……」
PRINTFORMW 「あはははは！変なとこ触らないでよ、気持ちよくなっちゃう%UNICODE(0x2665) *1%」	PRINTFORMW 「啊哈哈哈！不要碰奇怪的地方呀、变得舒服起来了%UNICODE(0x2665) *1%」
PRINTFORMW 「そういうことなら……お返しするわよ？」	PRINTFORMW 「这样的话……我要反击咯？」
PRINTFORMW 蓮子はそう言って抱き着いてきている。	PRINTFORMW 蓮子这样说着抱了过来。
PRINTFORMW 「んっ、ちょっと激しいわ……%UNICODE(0x2665) *1%」	PRINTFORMW 「嗯、有点激烈呀……%UNICODE(0x2665) *1%」
PRINTFORMW 「ん、くすぐったいわ」	PRINTFORMW 「嗯、痒痒的」
PRINTFORMW 「……今変なとこ触った？」	PRINTFORMW 「……刚刚是不是摸到了奇怪的地方？」
PRINTFORMW 「何よ、くすぐったいんだけど？」	PRINTFORMW 「什么啊、很痒的说？」
PRINTFORMW 「暑苦しいわ、メリーみたい」	PRINTFORMW 「好热啊、怎么和梅莉一个样」
PRINTFORMW 「そんなに触りたいのならそういう店にでも行ったら？」	PRINTFORMW 「你要是这么想摸的话就去那种店不就行了吗？」
PRINTFORMW 「……これでいい？」	PRINTFORMW 「……这样就行了嘛？」
PRINTFORMW 「メリーじゃないんだから……」	PRINTFORMW 「你又不是梅莉……」
PRINTFORMW 「下心丸見えよ？」	PRINTFORMW 「你的意图暴露了哦？」
PRINTFORMW 「ちょっと気持ち悪……」	PRINTFORMW 「有点恶心……」
PRINTFORMW 「……何するのよ」	PRINTFORMW 「……你要干什么」
PRINTFORMW %CALLNAME:MASTER%が蓮子に対して非礼を詫びると	PRINTFORMW %CALLNAME:MASTER%为自己对蓮子做的无礼行为道歉
PRINTFORMW 「最初からそう殊勝な態度を取っていれば良かったのよ」	PRINTFORMW 「从一开始就用这种态度对人不就好了吗」
PRINTFORMW 蓮子はそう笑みを浮かべながら赦した。	PRINTFORMW 蓮子笑着原谅了他。
PRINTFORMW 「まだ反省が足りてないわ」	PRINTFORMW 「你反省的还不够」
PRINTFORMW 蓮子は笑っていない目でそう言い放った。	PRINTFORMW 蓮子用没有笑意的眼神说着。
PRINTFORMW 「肩でも揉んでもらおうかしら？」	PRINTFORMW 「能帮我揉一下肩膀吗？」
PRINTFORMW 「ペン取ってもらえる？」	PRINTFORMW 「能帮我拿个笔吗？」
PRINTFORMW 「じゃあ茶でも淹れてきて頂戴♪」	PRINTFORMW 「那么请给我泡杯茶吧♪」
PRINTFORMW 「……変態」	PRINTFORMW 「……变态」
PRINTFORMW 蓮子は苛立った様子で膝を差し出した。	PRINTFORMW 蓮子焦急地伸出了膝盖。
PRINTFORMW 「眠ってしまっても私はここに居るわよ？」	PRINTFORMW 「就算你睡着了我也会呆在这里哦？」
PRINTFORMW 「私の太股は値千金でしょ？」	PRINTFORMW 「我的大腿值千金吧？」
PRINTFORMW 「よしよし、良い子ね」	PRINTFORMW 「乖哦乖哦、好孩子」
PRINTFORMW 「ほら、膝枕してあげるわ」	PRINTFORMW 「来吧、给你膝枕哟」
PRINTFORMW 「よしよし、私もメリーにしてもらうわ」	PRINTFORMW 「乖哦乖哦、我之后也让梅莉给我做吧」
PRINTFORMW 「どう？気持ちよく寝られそう？」	PRINTFORMW 「怎样？能舒服的睡着吗？」
PRINTFORMW 「ちょっと脚痛いけど面白いわね」	PRINTFORMW 「虽然腿有点痛但是很有趣呢」
PRINTFORMW 「まるで赤ちゃんみたいね、よしよし」	PRINTFORMW 「简直就像婴儿一样呢、乖哦乖哦」
PRINTFORMW 「ゆっくり寝てて良いわよ？」	PRINTFORMW 「你可以好好睡一觉哦？」
PRINTFORMW 「……お金取るわよ？」	PRINTFORMW 「……要收费的哦？」
PRINTFORMW 「こんなのが好きなんだから男って最低よね」	PRINTFORMW 「竟然会喜欢做这种事、男人果然最差劲了」
PRINTFORMW 「はぁ……いいけど」	PRINTFORMW 「哈啊……虽然可以啦」
PRINTFORMW 「痛いんだけど？」	PRINTFORMW 「很痛的说？」
PRINTFORMW 蓮子はジト眼で問い詰めてくる。	PRINTFORMW 蓮子盯着这边追问着。
PRINTFORMW 「ふぅん、じゃあお返しよ？」	PRINTFORMW 「嗯、我要反击咯？」
PRINTFORMW 蓮子は頬をつままれるとやり返してきた。	PRINTFORMW 蓮子保持着被捏脸颊的状态捏了回来。
PRINTFORMW 「ん～？どうかしたの？」	PRINTFORMW 「嗯～？怎么了？」
PRINTFORMW 「そんなに摘ままなくても%CALLNAME:MASTER%の物よ？」	PRINTFORMW 「不用这样捏着我也是%CALLNAME:MASTER%的东西哦？」
PRINTFORMW 「何？私のほっぺたを摘まむのが流行ってるの？」	PRINTFORMW 「什么？现在很流行捏我的脸蛋吗？」
PRINTFORMW 蓮子はそういってつまみ返してきた。	PRINTFORMW 蓮子这么说着捏了回来。
PRINTFORMW 「いひゃひゃ……もうっ！いきなり摘ままないでよ！」	PRINTFORMW 「咦呀呀……真是的！不要突然捏过来呀！」
PRINTFORMW 蓮子は少し頬を紅潮させながら抗議している。	PRINTFORMW 蓮子一边摸着有些红的脸一边抗议着。
PRINTFORMW 「んん～？どうかしひゃひょ？」	PRINTFORMW 「嗯嗯～？怎么呀哟？」
PRINTFORMW 蓮子は言いにくそうに抗議している。	PRINTFORMW 蓮子口齿不清地抗议着。
PRINTFORMW 「んん？私のほっぺはただじゃ無いわよ？」	PRINTFORMW 「嗯嗯？我的脸蛋可不便宜哦？」
PRINTFORMW 「んむ？お金取るわよ？」	PRINTFORMW 「姆？要收费的哦？」
PRINTFORMW 「ちょっと痛いって……」	PRINTFORMW 「有点痛的……」
PRINTFORMW 「あんた何するのよ……」	PRINTFORMW 「你要干什么哟……」
PRINTFORMW 「あんたに摘ままれる謂われは無いんだけど」	PRINTFORMW 「我没有被你捏脸颊的理由吧」
PRINTFORMW 「ん？何かあるの？」	PRINTFORMW 「嗯？有什么东西吗？」
PRINTFORMW 「……%CALLNAME:MASTER%……んん……」	PRINTFORMW 「……%CALLNAME:MASTER%……嗯嗯……」
PRINTFORMW 「……メリー……？」	PRINTFORMW 「……梅莉……？」
PRINTFORMW 「……キモっ」	PRINTFORMW 「……恶心」
PRINTFORMW 蓮子は冷たい視線を送っている。	PRINTFORMW 蓮子用冰冷的视线看了过来。
PRINTFORMW 「わざわざそんなことをしなくても振り向くわよ、%CALLNAME:MASTER%」	PRINTFORMW 「不用特意做这种事情我也会回头的哦、%CALLNAME:MASTER%」
PRINTFORMW 蓮子は嬉しそうに振り向いた。	PRINTFORMW 蓮子高兴的把头转了过来。
PRINTFORMW 「これでも華の女子大生だからね、美容には気を遣っているのよ」	PRINTFORMW 「别看这样我也是如花一般的女大学生、我也很注意美容的」
PRINTFORMW 「……メリーより肌つやは良いつもりよ？」	PRINTFORMW 「……我觉得我的皮肤比梅莉要好哦？」
PRINTFORMW 「ん？何よ？」	PRINTFORMW 「嗯？怎么了？」
PRINTFORMW 蓮子はそういってほほ笑んだ。	PRINTFORMW 蓮子这么说着笑了起来。
PRINTFORMW 「そんなに突っつかれても何も出ないわよ」	PRINTFORMW 「就算你这样戳也戳不出什么东西哟」
PRINTFORMW 「ん～？何よ～？」	PRINTFORMW 「嗯～？怎么了～？」
PRINTFORMW 「何よ、痛いんだけど」	PRINTFORMW 「什么啊、很痛的说」
PRINTFORMW 「あまりほっぺたを突っつかないでくれる？」	PRINTFORMW 「能不要一直戳我的脸蛋吗？」
PRINTFORMW 「まるでメリーみたいね」	PRINTFORMW 「简直就像梅莉一样呢」
PRINTFORMW 「何なの？」	PRINTFORMW 「干什么？」
PRINTFORMW 「どうかした？」	PRINTFORMW 「怎么了吗？」
PRINTFORMW 「そういうのは恋人としなさいよ、モテないわよ」	PRINTFORMW 「这种事情去和恋人做啊、你这样不会受欢迎的」
PRINTFORMW 「……んへへ……」	PRINTFORMW 「……姆嘿嘿……」
PRINTFORMW 「ちょっと止めてよ！気持ち悪い……」	PRINTFORMW 「等下快停下！好恶心……」
PRINTFORMW 「んー猫になった気分ね♪」	PRINTFORMW 「嗯ー好像变成猫了呢♪」
PRINTFORMW 「もっと撫でてくれてもいいわよ、特別にね♪」	PRINTFORMW 「再多摸摸我也可以哦、特別的呢♪」
PRINTFORMW 「うんうん、%CALLNAME:MASTER%になら私の頭も身体も委ねていいわ♪」	PRINTFORMW 「呜嗯、%CALLNAME:MASTER%的话我的头和身体都可以交给你哦♪」
PRINTFORMW 「あんまりこういうこと、他の人にするもんじゃなわよ、私にならいいけど」	PRINTFORMW 「这样的事、不要对别人做、只对我做就好了」
PRINTFORMW 「んん？何よ？何か付いてた？」	PRINTFORMW 「嗯嗯？怎么了？头上有什么东西吗？」
PRINTFORMW 「……なんだか変な気分」	PRINTFORMW 「……总觉得心情有些奇怪呢」
PRINTFORMW 「んー子供扱いしないで欲しいかも」	PRINTFORMW 「嗯ー我希望你不要把我当成孩子」
PRINTFORMW 「……別に良いけど」	PRINTFORMW 「……倒是可以啦」
PRINTFORMW 「あんまり触らないでくれる？」	PRINTFORMW 「能不要一直摸我吗？」
PRINTFORMW 「ああ、もう……髪が乱れるじゃない……」	PRINTFORMW 「啊啊、真是的……头发不都乱了吗……」
PRINTFORMW 「そういうのは他人にするもんじゃないわ、気持ち悪い」	PRINTFORMW 「这种事不应该对陌生人做、恶心」
PRINTFORMW 「……なんであんたなんかのお酒を飲まなきゃならないのよ……」	PRINTFORMW 「……为什么我一定要喝你给的酒啊……」
PRINTFORMW 蓮子は不機嫌なままお酒に口を付けた。	PRINTFORMW 蓮子不高兴地喝了酒。
PRINTFORMW 「こういうの、精神的なつながりだけど強固な物よ、乾杯♪」	PRINTFORMW 「酒瘾啊、虽然只是精神性的但却很难戒呢、干杯♪」
PRINTFORMW 蓮子は少し頬を染めながらお酒を飲んでいる。	PRINTFORMW 蓮子喝着酒脸上微微开始泛红。
PRINTFORMW 「ん～やっぱり一人より二人で呑む方がいいわね……%UNICODE(0x2665) *1%」	PRINTFORMW 「嗯～果然两个人喝比一个人喝好啊……%UNICODE(0x2665) *1%」
PRINTFORMW 蓮子はそう言いながらお酒を口にした。	PRINTFORMW 蓮子一边说着一边把酒送入口中。
PRINTFORMW 「それじゃあ、二人の仲に乾杯%UNICODE(0x2665) *1%」	PRINTFORMW 「那么就、为两人的友谊干杯%UNICODE(0x2665) *1%」
PRINTFORMW 「これで名実ともに秘封倶楽部ね♪」	PRINTFORMW 「这就是名副其实的秘封俱乐部♪」
PRINTFORMW 「私と盃を交わすんだから責任取ってよね？」	PRINTFORMW 「和我喝交杯酒什么的你可要负责任哦？」
PRINTFORMW 「頂戴します♪」	PRINTFORMW 「我喝了♪」
PRINTFORMW 「ん……また会いましょう……私の夢の中でね」	PRINTFORMW 「嗯……下次再见吧……在我的梦中」
PRINTFORMW 「人を怒らせておいて何様のつもりよ！？」	PRINTFORMW 「你把我惹毛了又想做什么！？」
PRINTFORMW 「うんうん、こういう枕だから良い夢が見られるのね」	PRINTFORMW 「呜嗯、因为是这样的枕头所以能做个好梦呢」
PRINTFORMW 「そういや枕の押し売りってのもあるみたいね、私にはこれが良いけど」	PRINTFORMW 「说起来好像也有卖这种样式的枕头的不过对我来说这个就好了」
PRINTFORMW 「なんだか変な感じね、少しくすぐったいって言うか」	PRINTFORMW 「总觉得有点奇怪呢、应该说是有点痒吗」
PRINTFORMW 「意外と良い寝心地よ、褒めてあげるわ」	PRINTFORMW 「意外地能睡得很舒服呢、值得表扬哦」
PRINTFORMW 「もう少し足の筋肉を緩くしてくれると良いんだけど」	PRINTFORMW 「如果能再放松一点腿的肌肉就好了」
PRINTFORMW 「んー眠くなってきたかも……」	PRINTFORMW 「嗯ー有点想睡觉了……」
PRINTFORMW 「……ちょっと変な臭いするわね」	PRINTFORMW 「……有点奇怪的味道呢」
PRINTFORMW 「メリーの膝枕の方が良かったかも」	PRINTFORMW 「也许梅莉的膝枕要更好」
PRINTFORMW 「まあ、悪くない寝心地かもね」	PRINTFORMW 「嘛、也许能睡个不错的觉」
PRINTFORMW 「汗臭いわねぇ、これだから男は……」	PRINTFORMW 「一股汗臭味、所以说男人啊……」
PRINTFORMW 「変な臭いするんだけど……」	PRINTFORMW 「有一股奇怪的味道的说……」
PRINTFORMW 「……臭っ……」	PRINTFORMW 「……好臭……」
PRINTFORMW 「ちょっと興奮しすぎ……」	PRINTFORMW 「有点兴奋过头了……」
PRINTFORMW 「青姦趣味は持ち合わせてないの、生憎ね」	PRINTFORMW 「真不凑巧、我没有在外面做的兴趣」
PRINTFORMW 「メリーならともかく乱交なんて愛が無いわ」	PRINTFORMW 「乱交什么的是没有爱的如果是梅莉的话就另当别论了」
PRINTFORMW 「全く……雰囲気も作れないって最低な男ね」	PRINTFORMW 「真是的……连气氛都不会营造真是个差劲的男人啊」
PRINTFORMW 「へぇ……私を犯す甲斐性ぐらいはあるのね……%UNICODE(0x2665) *1%」	PRINTFORMW 「诶……侵犯我的志气你还是有的嘛……%UNICODE(0x2665) *1%」
PRINTFORMW 「……キスぐらいしなさいよ、もう……」	PRINTFORMW 「……接吻什么的先做啊、真是的……」
PRINTFORMW 「……最っ低っ……%UNICODE(0x2665) *1%」	PRINTFORMW 「……差劲……%UNICODE(0x2665) *1%」
PRINTFORMW 「んんっ%UNICODE(0x2665) *1%……ん～%UNICODE(0x2665) *1%」	PRINTFORMW 「嗯嗯%UNICODE(0x2665) *1%……嗯～%UNICODE(0x2665) *1%」
PRINTFORMW 「そういうのは恋人同士でする物よ」	PRINTFORMW 「这种事是恋人之间才能做的事」
PRINTFORMW 「すぐそういうこと考えるの嫌いよ」	PRINTFORMW 「一上来就想做这种事情我不喜欢」
PRINTFORMW 蓮子は%CALLNAME:MASTER%の頬を引っ叩いた。	PRINTFORMW 蓮子对着%CALLNAME:MASTER%的脸扇了过去。
PRINTFORMW 「ん……私もそんな気分だったの%UNICODE(0x2665) *1%」	PRINTFORMW 「嗯……我也有这个打算%UNICODE(0x2665) *1%」
PRINTFORMW 「ん……%UNICODE(0x2665) *1%」	PRINTFORMW 「嗯……%UNICODE(0x2665) *1%」
PRINTFORMW 「結局身体の結びつきが一番強固なのよね」	PRINTFORMW 「到最后果然身体的结合是最紧密的呢」
PRINTFORMW 「こんなの続けてたら馬鹿になっちゃう……%UNICODE(0x2665) *1%」	PRINTFORMW 「这样继续下去的话会变成傻瓜的……%UNICODE(0x2665) *1%」
PRINTFORMW 「今日は優しくしてよねっ……%UNICODE(0x2665) *1%」	PRINTFORMW 「今天要温柔一点哦……%UNICODE(0x2665) *1%」
PRINTFORMW 「何しても良いけど責任は取ってね%UNICODE(0x2665) *1%」	PRINTFORMW 「做什么都可以不过你要负责哦%UNICODE(0x2665) *1%」
PRINTFORMW 「メリーには内緒よ？」	PRINTFORMW 「要对梅莉保密哦？」
PRINTFORMW 「求められるのは好きよ」	PRINTFORMW 「这种被索求的感觉我喜欢哟」
PRINTFORMW 「ん……ちゃんと身体洗った？」	PRINTFORMW 「嗯……好好洗澡了吗？」
PRINTFORMW 「……いいけど責任取りなさいよ」	PRINTFORMW 「……倒是可以啦但你要负责啊」
PRINTFORMW 「さっさと済ませてよね」	PRINTFORMW 「快点做完吧」
PRINTFORMW 「へぇ、結構強引なんだ」	PRINTFORMW 「诶、你还挺强硬的」
PRINTFORMW 「何？秘封倶楽部の活動のものまね？」	PRINTFORMW 「什么？模仿秘封俱乐部的活动？」
PRINTFORMW 「……何かあるんだ？」	PRINTFORMW 「……有什么事？」
PRINTFORMW 「私と恋人に？」	PRINTFORMW 「和我成为恋人？」
PRINTFORMW 告白を受けた蓮子は暫くの沈黙の後おずおずと口を開いた。	PRINTFORMW 接受了告白的蓮子在沉默了一段时间后怯生生地开口了。
PRINTFORMW 「……ま、それも面白いかもね」	PRINTFORMW 「……嘛、也许这样也很有趣」
PRINTFORMW 「いいわ、付き合ったげる」	PRINTFORMW 「好啊、我和你交往」
PRINTFORMW 「同情じゃないわ、結構%CALLNAME:MASTER%のことタイプだしそれに――」	PRINTFORMW 「不是在同情你、%CALLNAME:MASTER%的确是我喜欢的类型、而且――」
PRINTFORMW 「%CALLNAME:MASTER%の夢、私も見たいからね」	PRINTFORMW 「%CALLNAME:MASTER%的梦、我也想看呢」
PRINTFORMW 蓮子はそう言うと%CALLNAME:MASTER%の手を取り見つめてくる。	PRINTFORMW 蓮子这样说着牵起了%CALLNAME:MASTER%的手凝视过来。
PRINTFORMW 「%CALLNAME:MASTER%の眼には何が見えるのかしら？私だけ？それとも――」	PRINTFORMW 「%CALLNAME:MASTER%的眼睛能看到什么呢？只有我？还是说――」
PRINTFORMW そう言いながら彼女は優しく口づけをした。	PRINTFORMW 这么说着她温柔的亲了过来。
PRINTFORMW 「何よ？気持ち悪いわね」	PRINTFORMW 「怎么了？真恶心啊」
PRINTFORMW 蓮子は何かあったのかと笑みを浮かべてそう尋ねてきた。	PRINTFORMW 蓮子笑着问我出了什么事。
PRINTFORMW 「さぁ？何考えてるのかしらね」	PRINTFORMW 「那么？你在想什么呢」
PRINTFORMW 「どこまでも主観的な観測結果の中で何が真実なのかしらね、主幹の外側に真実があるのに」	PRINTFORMW 「在主观的观测结果中到底什么才是真实的呢、明明在主观的外侧有着真相的说」
PRINTFORMW 「偽物でも本物に劣るとは限らないわ、そう私もね」	PRINTFORMW 「即使是假的也不一定比真的差、我也是」
PRINTFORMW 「うーん、このあたりだと可愛い服が売って無いのよねぇ」	PRINTFORMW 「呜ー嗯、这附近有没有卖可爱的衣服呢」
PRINTFORMW 「メリーってああ見えて力持ちなんだけど普段何食べてるのかしらね？合成プロテイン？」	PRINTFORMW 「别看梅莉那样她很有力气的、平常都在吃什么呢？合成蛋白粉？」
PRINTFORMW 「メリーの胸って何で大きいのかしら？人種の違い？」	PRINTFORMW 「梅莉的胸部为什么这么大？人种差异吗？」
PRINTFORMW 「どうにかして外に出られないかしら？部屋的な意味ではなくてね」	PRINTFORMW 「要怎么做才能出去呢？不是说出房间的意思」
PRINTFORMW 「なんであんたなんかと……！」	PRINTFORMW 「为什么要和你一起……！」
PRINTFORMW 蓮子は怒りながら食事をしている。	PRINTFORMW 蓮子生气地吃着饭。
PRINTFORMW 「せっかくのお料理だし楽しみましょう♪」	PRINTFORMW 「我难得做饭请好好期待吧♪」
PRINTFORMW 「せっかくだから%CALLNAME:MASTER%も食べると良いわ」	PRINTFORMW 「难得的机会%CALLNAME:MASTER%也一起吃吧」
PRINTFORMW 「汚い手で触らないでよ……全く」	PRINTFORMW 「别用你的脏手碰我……真的是」
PRINTFORMW 「そうねぇ、私より掃除うまいもんね、頼むわよ」	PRINTFORMW 「是呢、比我打扫得好啊、拜托了」
PRINTFORMW 「あーそういえばあれどこ行ったかしら？」	PRINTFORMW 「啊ー这么说来那个东西在哪来着？」
PRINTFORMW 「……変態！」	PRINTFORMW 「……变态！」
PRINTFORMW 蓮子は汗ばんだシャツの胸元を広げながらそう言った。	PRINTFORMW 莲子一边摊开满是汗的衬衫的胸口一边这样说。
PRINTFORMW 「はぁ……あっつ……」	PRINTFORMW 「哈啊……好热……」
PRINTFORMW 「ん……しんど……流石に本格的に運動すると疲れるわね」	PRINTFORMW 「嗯……累死了……果然认真运动的话会很累呢」
PRINTFORMW 「ん……水飲ませて……」	PRINTFORMW 「嗯……让我喝口水……」
PRINTFORMW 蓮子は%CALLNAME:MASTER%の事を無視している	PRINTFORMW 蓮子无视了%CALLNAME:MASTER%
PRINTFORMW 「……あー、そうね、今読んでるとこだから」	PRINTFORMW 「……啊ー、是呢、我现在正在读」
PRINTFORMW 蓮子は気のない返事をした。	PRINTFORMW 蓮子淡淡地回答到。
PRINTFORMW 「うん、中々興味深かったわ！特に――」	PRINTFORMW 「呜嗯、非常有趣呢！特别是――」
PRINTFORMW 蓮子の話は長く続きそうだ……	PRINTFORMW 看来蓮子的话要说很久……
PRINTFORMW 「気持ち悪いから一人で作っててよ」	PRINTFORMW 「太恶心了你一个人做吧」
PRINTFORMW 「二人で並んでると恋人みたいね」	PRINTFORMW 「两个人并排的话就像恋人一样呢」
PRINTFORMW 「へぇ、上手いんだ、こういうの」	PRINTFORMW 「诶、料理技术很棒呢」
PRINTFORMW 「勝手に食べてなさいよ……」	PRINTFORMW 「随便你吃吧……」
PRINTFORMW 「ほら、あーんしなさい%UNICODE(0x2665) *1%」	PRINTFORMW 「来、啊ー嗯ーーー%UNICODE(0x2665) *1%」
PRINTFORMW 「二人で作ったんだからきっと美味しいわ」	PRINTFORMW 「因为是两个人一起做的所以一定很好吃的」
PRINTFORMW 「%CALLNAME:MASTER%に横取りされたくないんだけど」	PRINTFORMW 「这个我可不想被%CALLNAME:MASTER%抢走的说」
PRINTFORMW 「色んなところに色んな物があるのよね、そう他とえばここにも……」	PRINTFORMW 「各种各样的地方都有各种各样的东西呢、比如说这里就有……」
PRINTFORMW 「へぇ、どっちも使い道が無いのにね」	PRINTFORMW 「诶、明明哪一个都没有用处呢」
PRINTFORMW 「大物釣れたら教えてよね」	PRINTFORMW 「如果能钓到大家伙的话请告诉我哦」
PRINTFORMW 「遠慮無く人体実験させてもらうわね」	PRINTFORMW 「不用客气、让我做人体实验吧」
PRINTFORMW 「へぇ、付き合いいいのね、じゃあそこに座ってもらえるかしら？」	PRINTFORMW 「诶、你愿意陪我真是太好了、那你能坐在那里吗？」
PRINTFORMW 「こーれーはー謎の神社で手に入れた謎のお札なんだけど付けてくれる？」	PRINTFORMW 「这ー个ー是ー在迷之神社拿到的迷之符箓你能贴在身上吗？」
PRINTFORMW 「じゃあ夢の世界を私達は共有できるのか、実験に付き合ってくれる？」	PRINTFORMW 「那么就我们的梦境世界能不能连在一起的课题来陪我做实验吧？」
PRINTFORMW 「ま、こういう時にこそ面白いアイデアが思い浮かぶのよね」	PRINTFORMW 「嘛、有些有趣的想法就是会在这种时候浮现的」
PRINTFORMW 「こうしているととても落ち着くわね、変な波動でも出てるのかしら？」	PRINTFORMW 「这样做的话会非常安心呢、你会发出什么奇怪的波动吗？」
PRINTFORMW 「ねえ、私のこと感じてくれてる？」	PRINTFORMW 「呐、你感受到我的感觉了吗？」
PRINTFORMW 「脳を休めるのも才能の一つよ」	PRINTFORMW 「让大脑休息也是一种才能哟」
PRINTFORMW 「朱に染まるのも悪くは無いわね」	PRINTFORMW 「染上朱红色也不错呢」
PRINTFORMW 「世界に余裕があるからのんびりできるのよ」	PRINTFORMW 「因为世界上有富余所以才可以悠闲地度过哦」
PRINTFORMW 蓮子は無表情で晩酌している。	PRINTFORMW 蓮子面无表情地晚酌着。
PRINTFORMW 「かんぱーい♪」	PRINTFORMW 「干杯ー♪」
PRINTFORMW 蓮子は頬を染めながら晩酌をしている。	PRINTFORMW 正在晚酌的蓮子脸上染上了一抹红色。
PRINTFORMW 「%CALLNAME:MASTER%と呑むから酔っちゃうのよ%UNICODE(0x2665) *1%」	PRINTFORMW 「和%CALLNAME:MASTER%一起喝酒的话会醉呢%UNICODE(0x2665) *1%」
PRINTFORMW 「二人で乾杯ね%UNICODE(0x2665) *1%」	PRINTFORMW 「两个人一起干杯%UNICODE(0x2665) *1%」
PRINTFORMW 「もったいないわ、飲んじゃいましょう」	PRINTFORMW 「太可惜了、喝掉吧」
PRINTFORMW 「やはり飲むなら旧型酒ね」	PRINTFORMW 「果然要喝还是要喝旧型酒呢」
PRINTFORMW 「せっかくだし飲んじゃおっか」	PRINTFORMW 「难得的机会喝一杯吧」
PRINTFORMW 「……付いてこないでよ」	PRINTFORMW 「……别跟过来」
PRINTFORMW 蓮子はぷりぷりと怒りながら買い物をしている。	PRINTFORMW 蓮子以怒气冲冲的样子买着东西。
PRINTFORMW 「こういった既製品が本物なのも面白いわね%UNICODE(0x2665) *1%」	PRINTFORMW 「看这样的工艺品是不是真的也很有趣呢%UNICODE(0x2665) *1%」
PRINTFORMW 蓮子は頬を染めながらそう言った。	PRINTFORMW 正在说话的蓮子脸上染上了一抹红色。
PRINTFORMW 「荷物持ってくれるの？ありがと♪」	PRINTFORMW 「要帮我拿着东西？谢谢♪」
PRINTFORMW 「こういうのデートみたいね%UNICODE(0x2665) *1%」	PRINTFORMW 「这样子好像约会呢%UNICODE(0x2665) *1%」
PRINTFORMW 「こういうのも本物なのよね」	PRINTFORMW 「这个也是真品的吧」
PRINTFORMW 「何買いましょっか？お酒？」	PRINTFORMW 「要买什么呢？酒？」
PRINTFORMW 「メリーに何か買っていきましょうよ」	PRINTFORMW 「给梅莉也买点什么吧」
PRINTFORMW 「……汚い」	PRINTFORMW 「……肮脏」
PRINTFORMW 蓮子は怒りながら雪だるまを作っている。	PRINTFORMW 蓮子愤怒地堆着雪人。
PRINTFORMW 「へぇ、こういうのも得意なのね、憧れるわ」	PRINTFORMW 「诶、你对这种事也很擅长呢、让人羡慕呢」
PRINTFORMW 「うう……こんなに雪が冷たいなんて聞いてないわ！」	PRINTFORMW 「呜……我没听说过雪是这么冷的东西啊！」
PRINTFORMW 「おやすみ、次は夢で会いましょ」	PRINTFORMW 「晚安、下次在梦中相会吧」
PRINTFORMW 「電子の夢も果たして夢なのかしらね、おやすみ」	PRINTFORMW 「电子的梦到底是梦吗、晚安」
PRINTFORMW 「今日はもう寝るのね、じゃあ次は夢の中でね？」	PRINTFORMW 「今天要睡觉了呢、那么下次在梦中再见吧？」
PRINTFORMW 「休憩しましょう！歩いて疲れたのよ」	PRINTFORMW 「休息一下吧！走累了」
PRINTFORMW 「こうしていると新しい考えが浮かんでくる物なのよ」	PRINTFORMW 「这样做的话新的想法就会浮现出来的哟」
PRINTFORMW 「こうしている間にも世界は動いてるのってなんだか不思議じゃない？」	PRINTFORMW 「这样做的时候世界也依然在运动、不觉得不可思议吗？」
PRINTFORMW 「全く言われなくても付いていくわよ」	PRINTFORMW 「就算你一句话也不说我也会跟着你的哦」
PRINTFORMW 「デートに誘ってくれるなんてお目が高いわね」	PRINTFORMW 「你邀请我去约会真是太有眼光了」
PRINTFORMW 「何？奢ってくれるの？」	PRINTFORMW 「什么？要请我吃饭？」
PRINTFORMW 「へぇ？まあいいけど」	PRINTFORMW 「诶？倒是可以啦」
PRINTFORMW 「勝手に触らないでよ、整理してるのに」	PRINTFORMW 「别随便碰啊、明明整理好了的」
PRINTFORMW 「メリーみたいに綺麗な部屋じゃ無いからね、助かるわ」	PRINTFORMW 「这里不是像梅莉那样干净的房间、帮大忙了」
PRINTFORMW 「こういうの、苦手なのよね……」	PRINTFORMW 「这种事、我不擅长呢……」
PRINTFORMW 「折角だから私も手伝ってあげるわ！」	PRINTFORMW 「机会难得我也来帮忙吧！」
PRINTFORMW 「あんたと居ると知能が下がるのよ……」	PRINTFORMW 「和你在一起智力会下降……」
PRINTFORMW 「あら？プランク並みの脳みそを持つ私に勉強を見てもらうんだから感謝しなさい？」	PRINTFORMW 「啊拉？和这个拥有普朗克一般头脑的我一起学习可要心怀感谢啊？」
PRINTFORMW 「こんな簡単な問題でも解説するとなると難しい物ね」	PRINTFORMW 「这么简单的问题解说起来也很难啊」
PRINTFORMW 「主体の外側にこそ真実があるの、つまり客体が世界を作っているのよ」	PRINTFORMW 「只有主体的外侧才有真实、也就是说世界是由客体创造的」
PRINTFORMW 「私の知らない世界に会えますように」	PRINTFORMW 「希望能见到我所不知道的世界」
PRINTFORMW 「このままデートでもしない？神頼みもそれまでよ」	PRINTFORMW 「就这样去约会怎么样？求神就到这吧」
PRINTFORMW 「課題は多いわね、頼りにしてるわよ？」	PRINTFORMW 「我有很多课题呢、就拜托你了哟？」
PRINTFORMW 「一緒に浸かりましょうよ？ダメ？」	PRINTFORMW 「一起泡吧？不行吗？」
PRINTFORMW 「へえ、天然掛け流しって風流ってやつね！」	PRINTFORMW 「诶、天然的温泉是风流啊！」
PRINTFORMW 「……あまり覗かないでね？」	PRINTFORMW 「……不要偷看哟？」
PRINTFORMW 「私とじゃ無くてメリーの方が良かったんじゃない？」	PRINTFORMW 「不是和我而是梅莉一起来不是更好吗？」
PRINTFORMW 「……黙っててよ」	PRINTFORMW 「……闭嘴吧」
PRINTFORMW 蓮子は一人で黙々と読書をしている。	PRINTFORMW 蓮子一个人默默地读书。
PRINTFORMW 「へえ？%CALLNAME:MASTER%も本を読むんだ？」	PRINTFORMW 「诶？%CALLNAME:MASTER%也要读书？」
PRINTFORMW 「本を読むときは静かにするものよ、誰にも邪魔されずにね」	PRINTFORMW 「读书时要保持安静、不要打扰任何人哦」
PRINTFORMW 「私達の同人誌ももっと広まればいいのにね」	PRINTFORMW 「我们的同人志要是能更广为流传一点就好了呢」
PRINTFORMW 「こうしてるとメリーの気持ちも分かるわね」	PRINTFORMW 「这样的话我也能理解一些梅莉的心情呢」
PRINTFORMW 「何待ってるの？私も待たせてよ」	PRINTFORMW 「你在等什么？我也一起等吧」
PRINTFORMW 「待たせるのは得意だけど待つのは苦手なのよね～」	PRINTFORMW 「我很擅长被等但不擅长等人呢～」
PRINTFORMW 蓮子は手を振り払った。	PRINTFORMW 蓮子甩开了手。
PRINTFORMW 「……少し強引なところも好きよ%UNICODE(0x2665) *1%」	PRINTFORMW 「……你有点强硬这点我也喜欢哦%UNICODE(0x2665) *1%」
PRINTFORMW 「王子様は私をどこへ連れて行ってくれるのかしら？」	PRINTFORMW 「王子大人要带我去哪里呢？」
PRINTFORMW 「宇宙の果てまで私達の愛を確かめに行きましょっか？」	PRINTFORMW 「一起到宇宙的尽头去确认我们的爱吧？」
PRINTFORMW 「へえ、デートみたいね」	PRINTFORMW 「诶、像约会一样呢」
PRINTFORMW 「あんまりこう……男の子と手を繋ぐ事って少なかったから新鮮ね！」	PRINTFORMW 「没什么……和男孩子牵手的事很少所以很新鲜呢！」
PRINTFORMW 「すこし恥ずかしいわね、でも嬉しいかも……」	PRINTFORMW 「有点不好意思啊、但是很开心……」
PRINTFORMW 「メリーとはよく繋いでたけど……恥ずかしいわね」	PRINTFORMW 「虽然经常和梅莉牵手……真是害羞啊」
PRINTFORMW 「男の子と手を繋ぐって恥ずかしいわね……」	PRINTFORMW 「和男孩子牵手真是不好意思呐……」
PRINTFORMW 「どこに連れて行ってくれるのかしら？」	PRINTFORMW 「你会带我去哪里呢？」
PRINTFORMW 「ふーん、いいけど」	PRINTFORMW 「呼嗯ー、可以啦」
PRINTFORMW 「ここにもパパラッチはいるのかしら？居たら面倒ねぇ」	PRINTFORMW 「这里也有狗仔队吗？如果在的话就麻烦了」
PRINTFORMW 「……まあいいけどメリーには内緒にしてね」	PRINTFORMW 「……可以啦不过要对梅莉保密哦」
PRINTFORMW 「……ずいぶん暇なのね」	PRINTFORMW 「……你真闲啊」
PRINTFORMW 「へぇ？面白い物でもあったわけ？」	PRINTFORMW 「诶？是有有趣的东西吗？」
PRINTFORMW 「私も結界が見えたらいいんだけどね」	PRINTFORMW 「如果我也能看到结界就好了」
PRINTFORMW 「こうして散策の先に面白いのがあるのよねぇ」	PRINTFORMW 「就这样散步的前方会有有趣的地方对吧」
PRINTFORMW 「……勝手に頼めばいいじゃない」	PRINTFORMW 「……随便点不就好了吗」
PRINTFORMW 「%CALLNAME:MASTER%の好みってこういうのなんだ……少し意外ね」	PRINTFORMW 「%CALLNAME:MASTER%原来喜欢吃这些啊……有点意外呢」
PRINTFORMW 「へえ？いい店知ってるのね」	PRINTFORMW 「诶？你知道一家不错的店呢」
PRINTFORMW 「何にしようかな……色々あるって幸せよね」	PRINTFORMW 「要吃什么呢……有这么多选择真是幸福呢」
PRINTFORMW 「そのうちメニュー全部食べてしまいたいわね」	PRINTFORMW 「真想有一天能把菜单上的菜全部吃一遍呢」
PRINTFORMW 「……こういう店に来ると少し惨めになるの」	PRINTFORMW 「……来这种店有点悲惨呢」
PRINTFORMW 「店が悪いんじゃ無いけど合成食で満足してた自分にね」	PRINTFORMW 「不是说店家有什么不好而是说吃合成食物就能满足的我」
PRINTFORMW 「何か奢ってくれるの？」	PRINTFORMW 「要请我吃点什么？」
PRINTFORMW 「ここはメリーとも来たことが無かったわね」	PRINTFORMW 「我和梅莉都没来过这里呢」
PRINTFORMW 「何から食べよっかな……」	PRINTFORMW 「从什么开始吃呢……」
PRINTFORMW 「奢ってくれるなんて悪いわよ……」	PRINTFORMW 「让你请我吃饭真是不好意思……」
PRINTFORMW 「ま、私の舌に合うかは知らないけど」	PRINTFORMW 「嘛、虽然不知道合不合我的口味」
PRINTFORMW 「このお店は初めてね」	PRINTFORMW 「来这家店还是第一次呢」
PRINTFORMW 「こんなので機嫌が直る訳ないじゃない……馬鹿」	PRINTFORMW 「心情才不会因为这样就能变好……笨蛋」
PRINTFORMW 「へえ、嗜好品もやっぱり本物の方がいいわね%UNICODE(0x2665) *1%」	PRINTFORMW 「诶、嗜好品果然还是真的好啊%UNICODE(0x2665) *1%」
PRINTFORMW 「合成苺と合成卵、むしろ本物ばかりでの世界では価値が高まるんじゃない？」	PRINTFORMW 「合成草莓和合成鸡蛋、这些东西在全是真货的的世界会不会更有价值？」
PRINTFORMW 「無論私達もね」	PRINTFORMW 「当然我们也是」
PRINTFORMW 「甘い物でも合成した物とはずいぶん味に違いがあるのね」	PRINTFORMW 「即使是甜食也和合成的东西味道有很大的不同呢」
PRINTFORMW 「へぇ？甘い物なら大歓迎よ！」	PRINTFORMW 「诶？甜食的话大欢迎哦！」
PRINTFORMW 「やっぱり職人の手作りだと味が違うのよねぇ」	PRINTFORMW 「果然是手艺人亲手做的话味道就不一样了呢」
PRINTFORMW 「お酒に甘い物は鉄板よね」	PRINTFORMW 「用酒配甜食是绝配对吧」
PRINTFORMW 「メリーと一緒なら良かったのに」	PRINTFORMW 「要是能和梅莉一起来一次就好了」
PRINTFORMW 「茶うけってのがあるならお酒うけもあるわよね」	PRINTFORMW 「有茶具的话那也有酒壶的吧」
PRINTFORMW 「メリーにお土産を買っていってあげましょうか」	PRINTFORMW 「给梅莉买些伴手礼吧」
PRINTFORMW 「なんだっけ？鈴瑚屋？ってのが美味しいんだっけか？」	PRINTFORMW 「叫什么来着？鈴瑚屋？听说那里的东西很好吃？」
PRINTFORMW 「うーん……意外と種類があるわ……舐めてたわね」	PRINTFORMW 「呜ー嗯……意外的有很多种类呢……有点太小看这里了」
PRINTFORMW 「意外と和菓子って経験無いのよ……日本人なのに」	PRINTFORMW 「我意外地没有吃过和式点心的经验哦……虽然是日本人」
PRINTFORMW 「……一人で来たかったわね……」	PRINTFORMW 「……我想一个人来的……」
PRINTFORMW 「へぇ～！面白い本がいっぱいあるわね！」	PRINTFORMW 「诶～！有很多有趣的书呢！」
PRINTFORMW 「よりどりみどりってやつね！大学図書館より魅力的かも！」	PRINTFORMW 「这里有数不胜数的书呢！这也许比大学图书馆更有魅力！」
PRINTFORMW 「ただならぬ妖気を感じるわ……！」	PRINTFORMW 「我感觉到了非同寻常的妖气……！」
PRINTFORMW 「……魚の餌が増えたわね」	PRINTFORMW 「……鱼的饲料增加了呢」
PRINTFORMW 蓮子は一人で黙々と水面を見つめている。	PRINTFORMW 蓮子一个人默默地凝视着水面。
PRINTFORMW 「川魚ばかり……って事も無いのかしら？」	PRINTFORMW 「净是河鱼……也没有这样的事吗？」
PRINTFORMW 「釣った魚って美味しいのかしら？」	PRINTFORMW 「钓到的鱼好吃吗？」
PRINTFORMW 「昔の人はこうやって酒の肴を釣ってたのねぇ、私もやろうかしら？」	PRINTFORMW 「以前的人是这样钓下酒菜的呢、我也来钓吧？」
PRINTFORMW 「あちゃー怒られちゃったわね……」	PRINTFORMW 「啊恰ー被发脾气了呢……」
PRINTFORMW 「長居しすぎたわ！次は何か買っていきましょ」	PRINTFORMW 「我等太久了！下次再买点什么吧」
PRINTFORMW 「ああ、もっと見てたかったのに……！」	PRINTFORMW 「啊啊、我明明想再看一看的……！」
PRINTFORMW 「もう少し見ていたかったわね」	PRINTFORMW 「我还想再看一会儿呢」
PRINTFORMW 「中々面白かったわね！また来ましょう！」	PRINTFORMW 「里面很有趣呢！下次再来吧！」
PRINTFORMW 「いいお店見つけたわね！」	PRINTFORMW 「找到好店了呢！」
PRINTFORMW 「うん、まあもらっておくわ」	PRINTFORMW 「呜嗯、我就先收下了」
PRINTFORMW 蓮子はあまり嬉しくなさそうだ……	PRINTFORMW 莲子好像不太高兴……
PRINTFORMW 「……一応礼は言っておくわ」	PRINTFORMW 「……总之谢谢我还是会说的」
PRINTFORMW 「……何だか胡散臭いわね」	PRINTFORMW 「……总觉得很可疑呢」
PRINTFORMW 「え？プレゼント？ありがと！」	PRINTFORMW 「欸？礼物？谢谢！」
PRINTFORMW 蓮子は少しはにかんだ笑顔を浮かべた。	PRINTFORMW 蓮子露出了略带羞涩的笑容。
PRINTFORMW 「へぇ？プレゼントなんて気が利くのね！？」	PRINTFORMW 「诶？送礼物什么的真机灵啊！？」
PRINTFORMW 「ありがとう、大切にするわ！」	PRINTFORMW 「谢谢、我会好好珍惜的！」
PRINTFORMW 「……ありがと、大切にするわ……！」	PRINTFORMW 「……谢谢、我会好好珍惜的……！」
PRINTFORMW 蓮子は頬を紅潮させて嬉しそうにしている。	PRINTFORMW 蓮子两颊绯红高兴极了。
PRINTFORMW 「こんなに私のこと考えてくれてたんだ……！」	PRINTFORMW 「你这么会为我着想啊……！」
PRINTFORMW 「ありがとう、こういうの好きよ！」	PRINTFORMW 「谢谢、我喜欢这个！」
PRINTFORMW 「……煩いわね」	PRINTFORMW 「……真烦人啊」
PRINTFORMW 「本を読む趣味はあるのね」	PRINTFORMW 「你有读书的兴趣呢」
PRINTFORMW 「……ダメね、妖魔本は読めないわ」	PRINTFORMW 「……不行呢、我看不懂妖魔书」
PRINTFORMW 「例えどんな文字でも規則性で書かれている限り解読可能なのよ」	PRINTFORMW 「不管是什么文字只要是有规律的就有解读的可能性」
PRINTFORMW 「勝手に入ればいいじゃない！」	PRINTFORMW 「你想进就进去吧！」
PRINTFORMW 蓮子はぶっきらぼうにそう言った。	PRINTFORMW 莲子冷冷地说。
PRINTFORMW 「じゃあ上がって頂戴」	PRINTFORMW 「那就上来吧」
PRINTFORMW 「今鍵開けるから待っててね」	PRINTFORMW 「现在我要开锁了等等哦」
PRINTFORMW 「……ちょっと待っててね、少し片付けるから」	PRINTFORMW 「……稍微等一下哦、我稍微收拾一下」
PRINTFORMW 「ほら？気持ちいい%UNICODE(0x2665) *1%」	PRINTFORMW 「怎样？舒服吗%UNICODE(0x2665) *1%」
PRINTFORMW 「こんなに溜まってるなんて少しはすっきりしたんじゃない？」	PRINTFORMW 「积攒了这么多一起掏出来是不是舒服多了？」
PRINTFORMW 「全く汚いわね……お金取ってもいい？」	PRINTFORMW 「真脏啊……我可以收钱吗？」
PRINTFORMW 「全くなんでプランク並みの脳みそを持つ私がこんなこと……」	PRINTFORMW 「真的是、为什么有着能和普朗克相比的头脑的我要做这种事……」
PRINTFORMW 凍てついた時の中で蓮子の額にキスをした。	PRINTFORMW 在冻结的时间中亲吻了莲子的额头。
PRINTFORMW 「……んん……？」	PRINTFORMW 「……嗯嗯……？」
PRINTFORMW 蓮子はおかしな感触に寝言を発した。	PRINTFORMW 蓮子因为奇怪的触感说起了梦话。
PRINTFORMW 「ちょっと！やめてよ！」	PRINTFORMW 「等等！别这样！」
PRINTFORMW 蓮子はキッと睨みつけてきた。	PRINTFORMW 被蓮子狠狠地瞪了一眼。
PRINTFORMW 「ん、私の頭脳にキスしてくれるの？光栄ね%UNICODE(0x2665) *1%」	PRINTFORMW 「嗯、要亲吻我的头脑吗？我很荣幸%UNICODE(0x2665) *1%」
PRINTFORMW 「……やめなさいよ……%UNICODE(0x2665) *1%」	PRINTFORMW 「……别这样呀……%UNICODE(0x2665) *1%」
PRINTFORMW 「……こんなこと、メリーにはしないでよ？」	PRINTFORMW 「……真的是、不要对梅莉这样做哦？」
PRINTFORMW 「……そういうことするんだ」	PRINTFORMW 「……你会做这种事啊」
PRINTFORMW 「んっ%UNICODE(0x2665) *1%好きっ%UNICODE(0x2665) *1%んっ%UNICODE(0x2665) *1%」	PRINTFORMW 「嗯%UNICODE(0x2665) *1%喜欢%UNICODE(0x2665) *1%嗯%UNICODE(0x2665) *1%」
PRINTFORMW 「んっ……キスしか考えられない……んっ%UNICODE(0x2665) *1%」	PRINTFORMW 「嗯……除了接吻什么都没法思考了……嗯%UNICODE(0x2665) *1%」
PRINTFORMW （もう何も考えられなくなっちゃう……%UNICODE(0x2665) *1%）	PRINTFORMW （已经什么都没法思考了……%UNICODE(0x2665) *1%）
PRINTFORMW 蓮子は嫌々手を引かれている。	PRINTFORMW 蓮子不情愿地被拉着手。
PRINTFORMW 「たまには手を引かれるのも悪くないわね%UNICODE(0x2665) *1%」	PRINTFORMW 「偶尔被拉着手也不错呢%UNICODE(0x2665) *1%」
PRINTFORMW 「%CALLNAME:MASTER%はどこへ連れて行ってくれるの%UNICODE(0x2665) *1%」	PRINTFORMW 「%CALLNAME:MASTER%会带我去哪里呢%UNICODE(0x2665) *1%」
PRINTFORMW 「もう、話さないでよ？離さないからね%UNICODE(0x2665) *1%」	PRINTFORMW 「真是的、别放开哟？我不会放开你的%UNICODE(0x2665) *1%」
PRINTFORMW 「もう、そんなに引っ張らなくても付いていくわよ」	PRINTFORMW 「真是的、不用那么拽我也会跟着你的」
PRINTFORMW 「どこへ行くの？楽しみね！」	PRINTFORMW 「去哪里呢？好期待啊！」
PRINTFORMW 「メリーもこんな気持ちだったのかしらね」	PRINTFORMW 「梅莉也是这样的心情吗」
PRINTFORMW 「こういうのは私の方が得意なんだけどねぇ」	PRINTFORMW 「拉手的话我更擅长呢」
PRINTFORMW 「待って、そんなに走らないでって」	PRINTFORMW 「等等、别走这么快啊」
PRINTFORMW 「ああもう、強引ね？嫌いじゃ無いけど」	PRINTFORMW 「啊啊真是的、真强硬啊？虽然我不讨厌就是了」
PRINTFORMW 「どこに行くのよ」	PRINTFORMW 「要去哪里啊」
PRINTFORMW 「あまり引っ張らないでよ」	PRINTFORMW 「不要这么用力拉啊」
PRINTFORMW 「男って強引よね、自分の思い通りになると思ってるの」	PRINTFORMW 「男人真是很强硬呢、是觉得什么都会如你所愿吗」
PRINTFORMW 「責任取りなさいよね……%UNICODE(0x2665) *1%」	PRINTFORMW 「请负起责任哦……%UNICODE(0x2665) *1%」
PRINTFORMW 「こういうのは初めてね……%UNICODE(0x2665) *1%」	PRINTFORMW 「做这种事这是第一次呢……%UNICODE(0x2665) *1%」
PRINTFORMW 「んんっ%UNICODE(0x2665) *1%あっ%UNICODE(0x2665) *1%」	PRINTFORMW 「嗯嗯%UNICODE(0x2665) *1%啊%UNICODE(0x2665) *1%」
PRINTFORMW 「んっ%UNICODE(0x2665) *1%くるっ%UNICODE(0x2665) *1%」	PRINTFORMW 「嗯%UNICODE(0x2665) *1%咕%UNICODE(0x2665) *1%」
PRINTFORMW 「意外と勇気あるのね……いいわよ%UNICODE(0x2665) *1%」	PRINTFORMW 「意外地有勇气呢……可以哦%UNICODE(0x2665) *1%」
PRINTFORMW 「んんっ%UNICODE(0x2665) *1%ちょっとっ%UNICODE(0x2665) *1%激しっ%UNICODE(0x2665) *1%」	PRINTFORMW 「嗯嗯%UNICODE(0x2665) *1%等等%UNICODE(0x2665) *1%好激烈%UNICODE(0x2665) *1%」
PRINTFORMW 「この方が犯しやすい？これだから男は……」	PRINTFORMW 「这个体位比较方便侵犯？所以说男人啊……」
PRINTFORMW 「んっ%UNICODE(0x2665) *1%ああっ%UNICODE(0x2665) *1%」	PRINTFORMW 「嗯%UNICODE(0x2665) *1%啊啊%UNICODE(0x2665) *1%」
PRINTFORMW 「ああっ%UNICODE(0x2665) *1%突いてっ%UNICODE(0x2665) *1%」	PRINTFORMW 「啊啊%UNICODE(0x2665) *1%突进去了%UNICODE(0x2665) *1%」
PRINTFORMW 「顔ぐらい見せてよね……%UNICODE(0x2665) *1%」	PRINTFORMW 「至少让我看看脸啊……%UNICODE(0x2665) *1%」
PRINTFORMW 「こういうのも悪くはないわね……%UNICODE(0x2665) *1%」	PRINTFORMW 「这样也不坏啊……%UNICODE(0x2665) *1%」
PRINTFORMW 「んんっ%UNICODE(0x2665) *1%ちょっとっ%UNICODE(0x2665) *1%」	PRINTFORMW 「嗯嗯%UNICODE(0x2665) *1%等等%UNICODE(0x2665) *1%」
PRINTFORMW 「おっ%UNICODE(0x2665) *1%んんっ%UNICODE(0x2665) *1%」	PRINTFORMW 「哦%UNICODE(0x2665) *1%嗯嗯%UNICODE(0x2665) *1%」
PRINTFORMW 「ちょっ%UNICODE(0x2665) *1%いきなり犯さないでっ%UNICODE(0x2665) *1%」	PRINTFORMW 「等%UNICODE(0x2665) *1%不要突然侵犯我啊%UNICODE(0x2665) *1%」
PRINTFORMW 「お尻の穴なんて初めてよ……」	PRINTFORMW 「菊穴什么的还是第一次呢……」
PRINTFORMW 「ちょっと……ちゃんとほぐして……んっ%UNICODE(0x2665) *1%」	PRINTFORMW 「等等……温柔一点啊……嗯%UNICODE(0x2665) *1%」
PRINTFORMW 「んっ……変な感じ……」	PRINTFORMW 「嗯……奇怪的感觉……」
PRINTFORMW 「あっ……んんっ%UNICODE(0x2665) *1%」	PRINTFORMW 「啊……嗯嗯%UNICODE(0x2665) *1%」
PRINTFORMW 「んあっ……んんっ」	PRINTFORMW 「嗯啊……嗯嗯」
PRINTFORMW 「初めてだから優しく……んっ」	PRINTFORMW 「因为是第一次所以温柔……嗯」
PRINTFORMW 「あんまり慣れてないけど……%UNICODE(0x2665) *1%」	PRINTFORMW 「虽然不太习惯……%UNICODE(0x2665) *1%」
PRINTFORMW 「んっ……待って……んっ%UNICODE(0x2665) *1%」	PRINTFORMW 「嗯……等等……嗯%UNICODE(0x2665) *1%」
PRINTFORMW 「あっ……ああっ%UNICODE(0x2665) *1%」	PRINTFORMW 「啊……啊啊%UNICODE(0x2665) *1%」
PRINTFORMW 「ちょっと……優しくしてよね」	PRINTFORMW 「等等……会温柔的吧」
PRINTFORMW 「何するつもりよ……んん！？」	PRINTFORMW 「你想干什么啊……嗯嗯！？」
PRINTFORMW 「んっ……苦し……%UNICODE(0x2665) *1%」	PRINTFORMW 「嗯……好痛苦……%UNICODE(0x2665) *1%」
PRINTFORMW 「んっ%UNICODE(0x2665) *1%ちょっとっ%UNICODE(0x2665) *1%」	PRINTFORMW 「嗯%UNICODE(0x2665) *1%等等%UNICODE(0x2665) *1%」
PRINTFORMW 「んぐ……%UNICODE(0x2665) *1%」	PRINTFORMW 「呜咕……%UNICODE(0x2665) *1%」
PRINTFORMW 「そっちは初めてだから……%UNICODE(0x2665) *1%」	PRINTFORMW 「那里还是第一次所以……%UNICODE(0x2665) *1%」
PRINTFORMW 「んっ……まってっ%UNICODE(0x2665) *1%」	PRINTFORMW 「嗯……等等%UNICODE(0x2665) *1%」
PRINTFORMW 「んっ……ちょっと……%UNICODE(0x2665) *1%」	PRINTFORMW 「嗯……等等……%UNICODE(0x2665) *1%」
PRINTFORMW 「あっ……アナルはっ%UNICODE(0x2665) *1%」	PRINTFORMW 「啊……肛门啊%UNICODE(0x2665) *1%」
PRINTFORMW 「ん……んんっ%UNICODE(0x2665) *1%」	PRINTFORMW 「嗯……嗯嗯%UNICODE(0x2665) *1%」
PRINTFORMW 「これでもう責任取らないといけないわね……%UNICODE(0x2665) *1%」	PRINTFORMW 「这样的话你就得负起责任了……%UNICODE(0x2665) *1%」
PRINTFORMW 「いつまでも女の上に乗ってられるてわけじゃないわよね%UNICODE(0x2665) *1%」	PRINTFORMW 「也不能一直坐在女人身上呢%UNICODE(0x2665) *1%」
PRINTFORMW 「あははっ%UNICODE(0x2665) *1%いい顔してるわよ%CALLNAME:MASTER%っ%UNICODE(0x2665) *1%」	PRINTFORMW 「啊哈哈%UNICODE(0x2665) *1%露出了不错的表情呢%CALLNAME:MASTER%%UNICODE(0x2665) *1%」
PRINTFORMW 「んっ%UNICODE(0x2665) *1%んっ%UNICODE(0x2665) *1%もっと射精しなさいっ%UNICODE(0x2665) *1%」	PRINTFORMW 「嗯%UNICODE(0x2665) *1%嗯%UNICODE(0x2665) *1%多射点出来呀%UNICODE(0x2665) *1%」
PRINTFORMW 「ああっ%UNICODE(0x2665) *1%妊娠しちゃう……%UNICODE(0x2665) *1%」	PRINTFORMW 「啊啊%UNICODE(0x2665) *1%要怀孕了……%UNICODE(0x2665) *1%」
PRINTFORMW 「んっ%UNICODE(0x2665) *1%体力があるのは感心するわね%UNICODE(0x2665) *1%」	PRINTFORMW 「嗯%UNICODE(0x2665) *1%我很佩服你这么有体力%UNICODE(0x2665) *1%」
PRINTFORMW 「もっとっ%UNICODE(0x2665) *1%突いてっ%UNICODE(0x2665) *1%」	PRINTFORMW 「更多更多%UNICODE(0x2665) *1%突进去%UNICODE(0x2665) *1%」
PRINTFORMW 「あっ%UNICODE(0x2665) *1%んんっ%UNICODE(0x2665) *1%」	PRINTFORMW 「啊%UNICODE(0x2665) *1%嗯嗯%UNICODE(0x2665) *1%」
PRINTFORMW 「んっ%UNICODE(0x2665) *1%ほらっ%UNICODE(0x2665) *1%んんっ%UNICODE(0x2665) *1%」	PRINTFORMW 「嗯%UNICODE(0x2665) *1%看招%UNICODE(0x2665) *1%嗯嗯%UNICODE(0x2665) *1%」
PRINTFORMW 「ずいぶんと立派ね%UNICODE(0x2665) *1%」	PRINTFORMW 「真是了不起呢%UNICODE(0x2665) *1%」
PRINTFORMW 「もっと犯しなさいっ%UNICODE(0x2665) *1%」	PRINTFORMW 「在做一次吧%UNICODE(0x2665) *1%」
PRINTFORMW 「こっちで気持ちよくしてあげる%UNICODE(0x2665) *1%」	PRINTFORMW 「用这边让你舒服起来%UNICODE(0x2665) *1%」
PRINTFORMW 「アナルの方でするのは初めてね%UNICODE(0x2665) *1%」	PRINTFORMW 「用肛门来做还是第一次呢%UNICODE(0x2665) *1%」
PRINTFORMW 「もっとっ%UNICODE(0x2665) *1%んっ%UNICODE(0x2665) *1%」	PRINTFORMW 「更多更多%UNICODE(0x2665) *1%嗯%UNICODE(0x2665) *1%」
PRINTFORMW 「んっ……こっちでもしてあげるわっ……%UNICODE(0x2665) *1%」	PRINTFORMW 「嗯……用这里给你弄出来……%UNICODE(0x2665) *1%」
PRINTFORMW 「ん……%UNICODE(0x2665) *1%責任取ってよね%UNICODE(0x2665) *1%」	PRINTFORMW 「嗯……%UNICODE(0x2665) *1%你要负责啊%UNICODE(0x2665) *1%」
PRINTFORMW 「密着すると気持ちいいってのは本当ね……%UNICODE(0x2665) *1%」	PRINTFORMW 「贴在一起的话会很舒服是真的呢……%UNICODE(0x2665) *1%」
PRINTFORMW 「あんまり見ないでよ……んっ……%UNICODE(0x2665) *1%」	PRINTFORMW 「不要一直盯着我啊……嗯……%UNICODE(0x2665) *1%」
PRINTFORMW 「この体位、好きよ……%UNICODE(0x2665) *1%」	PRINTFORMW 「这个体位、好喜欢……%UNICODE(0x2665) *1%」
PRINTFORMW 「ちょっ……いきなり抱えないで……んっ！？」	PRINTFORMW 「等等……不要突然抱过……嗯！？」
PRINTFORMW 「んんっ%UNICODE(0x2665) *1%%UNICODE(0x2665) *1%」	PRINTFORMW 「嗯嗯%UNICODE(0x2665) *1%%UNICODE(0x2665) *1%」
PRINTFORMW 「んっ%UNICODE(0x2665) *1%待ってっ%UNICODE(0x2665) *1%やばっ%UNICODE(0x2665) *1%」	PRINTFORMW 「嗯%UNICODE(0x2665) *1%等一下%UNICODE(0x2665) *1%不妙%UNICODE(0x2665) *1%」
PRINTFORMW 「んっ%UNICODE(0x2665) *1%やだっ%UNICODE(0x2665) *1%」	PRINTFORMW 「嗯%UNICODE(0x2665) *1%不妙%UNICODE(0x2665) *1%」
PRINTFORMW 「これっ%UNICODE(0x2665) *1%きつっ%UNICODE(0x2665) *1%んっ%UNICODE(0x2665) *1%」	PRINTFORMW 「这个%UNICODE(0x2665) *1%难顶%UNICODE(0x2665) *1%嗯%UNICODE(0x2665) *1%」
PRINTFORMW 「こっちの趣味もあるのね%UNICODE(0x2665) *1%」	PRINTFORMW 「你对这边也有兴趣呢%UNICODE(0x2665) *1%」
PRINTFORMW 「この体位でアナルって変態じゃない？」	PRINTFORMW 「这个体位用肛门来做不是变态吗？」
PRINTFORMW 「んっ%UNICODE(0x2665) *1%お”っ%UNICODE(0x2665) *1%」	PRINTFORMW 「嗯%UNICODE(0x2665) *1%啊%UNICODE(0x2665) *1%」
PRINTFORMW 「お……顔近……%UNICODE(0x2665) *1%」	PRINTFORMW 「啊……脸好进……%UNICODE(0x2665) *1%」
PRINTFORMW 「ちょっとどっちに挿入れてるのよ……んんっ！」	PRINTFORMW 「等等你插进了哪里啊……嗯嗯！」
PRINTFORMW 「これがいいの……変態ね%UNICODE(0x2665) *1%」	PRINTFORMW 「喜欢这样啊……变态%UNICODE(0x2665) *1%」
PRINTFORMW 「んっ%UNICODE(0x2665) *1%ん”ん”っ%UNICODE(0x2665) *1%」	PRINTFORMW 「嗯%UNICODE(0x2665) *1%嗯嗯%UNICODE(0x2665) *1%」
PRINTFORMW 「ん”っ%UNICODE(0x2665) *1%」	PRINTFORMW 「嗯%UNICODE(0x2665) *1%」
PRINTFORMW 「待って！そっちは……ん”！！！」	PRINTFORMW 「等等！那边是……嗯！！！」
PRINTFORMW 「これっ%UNICODE(0x2665) *1%んっ%UNICODE(0x2665) *1%ダメっ%UNICODE(0x2665) *1%」	PRINTFORMW 「这个%UNICODE(0x2665) *1%嗯%UNICODE(0x2665) *1%不行%UNICODE(0x2665) *1%」
PRINTFORMW 「あっ%UNICODE(0x2665) *1%あっ%UNICODE(0x2665) *1%」	PRINTFORMW 「啊%UNICODE(0x2665) *1%啊%UNICODE(0x2665) *1%」
PRINTFORMW 「あんっ%UNICODE(0x2665) *1%んっ%UNICODE(0x2665) *1%ダメっ%UNICODE(0x2665) *1%」	PRINTFORMW 「啊恩%UNICODE(0x2665) *1%嗯%UNICODE(0x2665) *1%不行%UNICODE(0x2665) *1%」
PRINTFORMW 「あっ%UNICODE(0x2665) *1%イクっ%UNICODE(0x2665) *1%」	PRINTFORMW 「啊%UNICODE(0x2665) *1%去了%UNICODE(0x2665) *1%」
PRINTFORMW 「あんっ%UNICODE(0x2665) *1%ダメっ%UNICODE(0x2665) *1%馬鹿になっちゃうっ%UNICODE(0x2665) *1%%UNICODE(0x2665) *1%」	PRINTFORMW 「啊恩%UNICODE(0x2665) *1%不行%UNICODE(0x2665) *1%要变成笨蛋了%UNICODE(0x2665) *1%%UNICODE(0x2665) *1%」
PRINTFORMW 「んっ%UNICODE(0x2665) *1%んっ%UNICODE(0x2665) *1%ダメっ%UNICODE(0x2665) *1%イクっ%UNICODE(0x2665) *1%」	PRINTFORMW 「嗯%UNICODE(0x2665) *1%嗯%UNICODE(0x2665) *1%不行%UNICODE(0x2665) *1%去了%UNICODE(0x2665) *1%」
PRINTFORMW 「んっ%UNICODE(0x2665) *1%そっちはっ%UNICODE(0x2665) *1%」	PRINTFORMW 「嗯%UNICODE(0x2665) *1%那边是%UNICODE(0x2665) *1%」
PRINTFORMW 「んっ%UNICODE(0x2665) *1%%UNICODE(0x2665) *1%やだっ%UNICODE(0x2665) *1%イっちゃうっ%UNICODE(0x2665) *1%」	PRINTFORMW 「嗯%UNICODE(0x2665) *1%%UNICODE(0x2665) *1%不妙%UNICODE(0x2665) *1%要去了%UNICODE(0x2665) *1%」
PRINTFORMW 「っ%UNICODE(0x2665) *1%アナルはダメっ%UNICODE(0x2665) *1%」	PRINTFORMW 「啊%UNICODE(0x2665) *1%肛门不行%UNICODE(0x2665) *1%」
PRINTFORMW 「もっとぉ%UNICODE(0x2665) *1%お尻の穴犯してっ%UNICODE(0x2665) *1%」	PRINTFORMW 「更多更多%UNICODE(0x2665) *1%侵犯我的菊穴啊%UNICODE(0x2665) *1%」
PRINTFORMW 「っ%UNICODE(0x2665) *1%好きっ%UNICODE(0x2665) *1%」	PRINTFORMW 「啊%UNICODE(0x2665) *1%喜欢%UNICODE(0x2665) *1%」
PRINTFORMW 「お尻っ%UNICODE(0x2665) *1%だめぇっ%UNICODE(0x2665) *1%」	PRINTFORMW 「屁股%UNICODE(0x2665) *1%不行%UNICODE(0x2665) *1%」
PRINTFORMW 「あっ%UNICODE(0x2665) *1%んっ%UNICODE(0x2665) *1%ダメっ%UNICODE(0x2665) *1%%UNICODE(0x2665) *1%%UNICODE(0x2665) *1%」	PRINTFORMW 「啊%UNICODE(0x2665) *1%嗯%UNICODE(0x2665) *1%不行%UNICODE(0x2665) *1%%UNICODE(0x2665) *1%%UNICODE(0x2665) *1%」
PRINTFORMW 「お尻っ%UNICODE(0x2665) *1%馬鹿になっちゃうっ%UNICODE(0x2665) *1%」	PRINTFORMW 「屁股%UNICODE(0x2665) *1%要变成笨蛋了%UNICODE(0x2665) *1%」
PRINTFORMW 「んっ%UNICODE(0x2665) *1%あっ%UNICODE(0x2665) *1%んんっ%UNICODE(0x2665) *1%」	PRINTFORMW 「嗯%UNICODE(0x2665) *1%啊%UNICODE(0x2665) *1%嗯嗯%UNICODE(0x2665) *1%」
PRINTFORML 『宇佐見蓮子』秘封倶楽部シリーズの登場人物で星を見ただけで今の時間が分かり、	PRINTFORML 『宇佐見蓮子』是秘封倶楽部系列的登場人物拥有能够通过看星星知道现在的时间、
PRINTFORML 月を見ただけで今居る場所が分かる程度の能力を持っています。	PRINTFORML 看月亮知道现在的位置的程度的能力。
PRINTFORML 彼女はマエリベリー・ハーンと共にオカルトサークル「秘封倶楽部」として活動しており	PRINTFORML 她与瑪愛露貝莉・赫恩一起在神秘学社团「秘封倶楽部」里进行活动
PRINTFORML 積極的に禁じられた結界暴きをして心霊現象の解明に取り組んでいます。	PRINTFORML 积极地进行着被禁止的结界探寻，致力于灵异现象的解明。